Ackley	RD
Alnetta	DR
Altadena	DR
Alvina	
Anchor	RD
Anderson	AVE
Anderson Cove	LN
Anderson Glen	DR
Anderson Hills	DR
Anderson Oak	DR
Andersonwoods	DR
Annapolis	DR
Apawana	CT
Apple Blossom	LANE
Apple Farm	LANE
Apple Hill	RD
Arlington	AVE
Artwood	DR
Asbury	RD
Asbury Hills	DR
Ashgrove	DR
Ashton	CT
Athenia	DR
Autumnleaf	LANE
Ayerdayl	LANE
Ayers	RD
Ayershire	AVE
Azure	CT
Balbriggan	CT
Barharbor	DR
Baribill	PL
Barnsdale	CT
Bartels	RD
Batavia	RD
Baytree	CT
Beacon	RD
Beaconwood	DR
Beechmont	AVE
Beechnut	DR
Beechshire	DR
Beechwood	TER
Beechwood Ln.	
Bennett	RD
Bennettwoods	CT
Berkinshaw	DR
Berkshire	RD
Berkshire Club	DR
Berrypatch	DR
Berrywood	DR
Bestview	TER
Bethany	LANE
Bilby	LANE
Birchdale	CT
Birney	LANE
Bishopsbridge	DR
Bittersea	CT
Blackthorn	DR
Blairhouse	DR
Blome	
Blue Orchard	DR
Bluecrest	DR
Bobwhite	
Bogarts	PT
Bonair	CT
Bonanza	LANE
Bondick	DR
Bowen	AVE
Braintree	CT
Brandonhill	CT
Brandychase Way	
Bretton	DR
Bridges	RD
Bridle	RD
Brixton	LANE
Broadwell	RD
Brooke	AVE
Brookestone	AVE
Brownsboro	PL
Bruce	AVE
Bruns	LANE
buckingham	
Burlinehills	CT
Burney	LANE
Butlersbridge	CT
Cabinet	CIR
Caledon	LANE
Calgery	DR
Candlemaker	DR
Capitol	DR
Cathedral Hill	DR
Causeway	LANE
Cedar Crest	LANE
Cedar Point	DR
Cherry	LANE
Chesterton	WAY
Chestnut	LANE
Chestnut Ridge	DR
Church	ST
Citadel	PL
Clemson	CIR
Clough	
Clough	LN
Clough	PIKE
Clough Ridge	DR
Clyde's Crossing	
Cohasset	CT
Coldstream	DR
Coldstream Woods	DR
Collinsdale	AVE
Collinspark	CT
Columbus	AVE
Concordgreen	DR
Concordridge	DR
Coolidge	AVE
Copperglow	CT
Coran	DR
Corbly	RD
Cottage Park	
Courtropes	LANE
Coventry Woods	DR
Crittenden	DR
Crosspointe	DR
Crotty	CT
Crystal Springs	
Deaconsbench	CT
Dela's Cove	
Denallen	DR
Denfield	CT
Dogwood	DR
Doolittle	LANE
Dry Run View	LANE
Dunn	RD
Dunview	CT
Dunwoodie	DR
Duxbury	CT
Eaglesknoll	CT
Eastdale	DR
Eglington	CT
Eight Mile	RD
Ellen	
Elstun	RD
Emerald Glade	LANE
Endovalley	DR
English	
Eton Cross	CT
Evelyn	DR
Evening Whisper	WAY
Eversole	RD
Executive	CT
Fair Grove	CT
Farmbrook	DR
Farmsworth	CT
Fehl	LANE
Fehl	LN
Finnegan	LANE
Fireside	DR
Five Mile	RD
Five Mile Trail	
Flaxen	CT
Forest	RD
Forestcrest	WAY
Forestlake	DR
Forestway	LANE
Four Mile	RD
Fourth	AVE
Fox Hollow	DR
Fox Valley	CT
Foxtrail	LANE
Friartuck	LANE
Gammwell	DR
Gilchrest	LANE
Ginger	LANE
Glenrose	LANE
Goldengate	DR
Grand Oaks	LN
Grandle	CT
Grant	AVE
Grantham	WAY
Greatoak	DR
Greenarbor	DR
Greenleaf	DR
Griffin Gate	
Gungadin	DR
Gwendolyn	DR
Halfcircle	CT
Hamiltonhills	DR
Hammerstone	WY
Hampton Place	LANE
Harcourt	DR
Hawkinsridge	LANE
Hawkslanding	DR
Hawkstone	DR
Heather Hill	BLVD
Heatherglen	DR
Heatherwood	LANE
Hickory Creek	DR
Hiddenglen	DR
Hiddenhills	DR
Hiddenpoint	LANE
High Meadows	DR
Hillridge	CT
Hilltree	DR
Hitchingpost	LANE
Holidayhills	DR
Holliston	PL
Holz	AVE
Hopper	RD
Hunley	RD
Huntcrest	DR
Hunters Knoll	LANE
I 275 Mile Marker 72	
I-275 northbound	
Immaculate	LANE
Indian Creek	RD
Indian Trace	CT
Innisbrook	PL
Interstate 275	HWY
Ivy Trails	DR
Jager	CT
Jakaro	DR
James Hill	DR
Jeannie	LANE
Joetta	DR
Kellogg	AVE
Kendara	CT
Kennebel	LANE
Kensington Ridge	DR
Kentucky View	DR
Kilkenny	DR
Killington	LANE
Kimbee	DR
King Louis	CT
Kingscove	WAY
Kingston View	CT
Kingsway	CT
Kipp	DR
Knightsbridge	DR
Koszo	DR
Ladyellen	DR
Lakewood	PT
Lamplite	CT
Lancelot	DR
Lanette	DR
Larry Joe	DR
Latiff	LANE
Laval	DR
Laverty	LANE
Lawyer	RD
Lawyers Point	DR
Lengwood	DR
Leroy	PL
Lilbur	LANE
Linder	LANE
Linderwood	LANE
Lindsey	LN
Linwood	
Little Dry Run	RD
Little Harbor	DR
Locksley	DR
Loisdale	CT
Loisview	LANE
Longbow	CT
Luwista	LANE
Maddux	DR
Maidmarian	DR
main	
Marcarol	LANE
Mariemont	
Markley	RD
Markley Woods	WAY
Marlborough	PL
Massies Grant	
Maycliffe	PL
Meadow Creek	DR
Meadowland	
Meadowland	DR
Meagan's	LANE
Merritt Grove	
Miles	
Mistymeadow	LANE
Monongahela	LANE
Montchateau	DR
Montegor	DR
Moorfield	DR
Moran	DR
Mountfort	CT
Mt. Carmel	RD
murray	
Muskegon	DR
Nagel	RD
New England Club	DR
Newtown	RD
Nimitzview	DR
Nine Mile	RD
Nitram	AVE
Nordica	LANE
Nordyke	RD
Northport	DR
Northwich	DR
Nottingham	DR
Ohio River	RIV
Old Chapel	DR
Old Kellogg	RD
Old State Route 74	
Oldbridge	RD
Oldforge	LANE
Overlook Hills	DR
Oysterbay	CT
Oysterbay	DR
Paddison	RD
Paddison Trails	DR
Pamela	DR
Pastoral	LANE
Patricia	LANE
Patterson Farms	LANE
Pebble	CT
Pee Wee	DR
Pembridge	DR
Perthview	CT
Petri	DR
Phillips	LANE
Picasso	CT
Pickwick	DR
Pine Run	DR
Pine Terrace	DR
Pinebluff	LANE
Pinewell	DR
Plazaview	CT
Pointe	PL
Portway	DR
Presidio	CT
Prilla	LANE
Queensway	LANE
Ragland	RD
Ramblinghills	DR
Ramundo	CT
Rathman	PL
Ravens	RUN
Redbank	
Regis	CT
Richland	DR
Ridgepoint	DR
Ridgestone	LANE
River Dee	CT
Riverby	RD
Riverpoint	LANE
Robinway	DR
Rockhurst	LANE
Roe	
Rolling Hills	DR
Rollingrock	LANE
Ropes	DR
Rosetree	LANE
Round Bottom	RD
Royalgreen	DR
Rustic Wood	LANE
Saddleback	DR
Salem	RD
Sandcliffe	DR
Sebright	LANE
Second	AVE
Shadowslope	LANE
Shady Hollow	LANE
Shadypine	DR
Shangrila	DR
Sharjoy	CT
Shenstone	DR
Sherman	AVE
Shewango	
Shimmering Bay	LANE
Shirmer	AVE
Sigma	CIR
Signal Hill	LANE
Smokey Woods	LANE
Sonny	DR
Spyglassridge	DR
SR 32	
St. Ives	PL
St. Thomas	CT
Stanley	RD
State	RD
Stirrup	RD
Stonegate	DR
Stonehill	DR
Stonington	RD
Stormy	WAY
Stratford Hill	DR
Strathcoma	DR
Stratton	DR
Street	St_type
Stutly	CT
Summerside	
Summithills	DR
Summitridge	DR
Sunderland	DR
Sunmont	DR
Sunny Acres	DR
Sunray	AVE
Susanview	LANE
Sutton	RD
Tallberry	DR
Thole	RD
Thornwood	CIR
Ticonderoga	CT
Tidewater	CT
Tonopah	DR
Towerview	LANE
Trade	
Tree Knoll	DR
Tree Ridge	DR
Trillium Ridge	LANE
Turnkey	CT
Turpin Hills	DR
Turpin Knoll	CT
Turpin Lake	PL
Turpin Oaks	CT
Turpin Valley	LANE
Turpin View	DR
Turpin Woods	CT
Turquoise	DR
Twelve Oaks	CT
US 50	
US 52	HWY
Valley	AVE
Van Vista	DR
Vancross	CT
Vaquera	PL
Velma	CT
Veraview	DR
Verdale	DR
Victor	AVE
Viking	CT
Virginia	LN
Voll	RD
Wanninger	LANE
Washington	CIR
Watch Hill	LANE
Watchcove	CT
Watchcreek	DR
Watchpoint	DR
Waterpoint	LANE
Wayside	AVE
Wayward Winds	DR
Wetheridge	DR
Wexwood	LANE
Whisper	LANE
Whispering Pines	DR
White Pine	CT
Whitehouse	LANE
Williams Creek	DR
Willow Hills	
Wilshire	AVE
Windhill	TER
Windyhills	RD
Winstone	CT
Wismar	DR
Witt	RD
Wittmeyer	DR
Witts Meadow	LANE
Witts Mill	LANE
Wittshire	CIR
Wittshire	LANE
Wolfangel	RD
Woodcroft	DR
Woodland Mound	DR
Woodlark	DR
Woodlyn	DR
Woodpine	LANE
Woodruff	RD
Woodsedge	DR
Woodstone	DR
Wooster	PI
Wooster	PIKE
Wycliffe	DR
Wyndwatch	DR
Yarger	DR
Yellowglen	DR
YMCA	RD
