10 1/2	St
100	Dr
10th	St
11 1/2	St
11th	
11th	Pl
11th	St
11th 1/2	St
12th	St
12th 1/2	St
13th	St
13th 1/2	St
14th	St
14th 1/2	St
15th	St
18	
18th	St
19th	St
1ST	Highway
20th	St
23rd	St
24	
24th	St
26th	St
27th	St
28	
28th	St
2nd	
2nd	St
31st	St
31st 1/2	St
32nd	St
32nd 1/2	St
33rd	St
34th	St
34th 1/2	St
35th	St
36th	St
38th	St
39th	St
3rd	St
40th	St
40th 1/2	St
41st	St
43rd	St
45	
45th	St
4th	
4th	St
54th	St
59	
5th	St
6 1/2	St
65th	St
66th	St
67th	St
69th	St
6th	
6th	St
700	
70th	St
71st	St
72nd	St
74th	St
75th	St
77th	St
78th	St
79th	St
8 1/2	St
80th	St
81st	St
8th	St
8th 1/2	St
97th	St
9th	St
Aberdeen Palms	Dr
Abilene	St
Academy	St
Acme	Ct
Acorn Clearing	Path
Acorn Forest	Dr
Acorn Meadow	St
Acorn Wood	Way
Acorn Wood Way	Cir
Acres	Dr
Adair	St
Adams	St
Adams Walk	Ct
Addicks Clodine	Rd
Addicks-Howell	Rd
Adolph	Dr
Adrian	St
Aeropark	Dr
Afton	St
Ahrens	St
Air Center	Blvd
Air Rice
Alabama	
Alabama	Ct
Alabama	St
Alabonson	Rd
Alaska	St
Alber	St
Albert	Dr
Albury	Dr
Albury Park	Ln	
Alder	Dr
Alderson	St
Aldine Bender	Rd
Aldine Mail Route	Rd
Aldine Meadows	Rd
Aldine Park	Ln
Aldine Ranchtown	Dr
Aldine Western	Rd
Aldine Westfield	Rd
Aldis	St
Aldon	St
Aletha	Ln
Algerian	Way
Algiers	Rd
Algonquin	Dr
Algregg	St
Alice	
Alice	St
Alief Clodine	Dr
Alief Clodine	Rd
Clodine	Rd
Allday	Dr
Allegheny	St
Allen	Pkwy
Allen	St
Allen Genoa	Rd
Allendale	Rd
Allendale Baptist Church S B C  414 Allen Genoa	Rd
Allensby	St
Allied Northborough Heliport	
Allston	St
Allum	Rd
Allwood	St
Almeda	Rd
Almeda Genoa	Rd
Almeda School	Rd
Almeda-Genoa	Rd
Alperton	
Alpine	Dr
Alpine	Rd
Alpine Ridge	Way
Alpine Vale	Ct
Alrover	St
Alsace	St
Alta Loma	Way
Alta Mesa	Dr
Alta Vista	St
Altic	St
Altic Ln	Ct
Alumni	Center
Alumni	Rd
Alvin	St
Amarillo	St
Amber Rose	Ln
Amblewood	Dr
Ambrose	
Ambrose	St
Ambursen	St
Amelia	Rd
American Martial Arts-Houston Kickboxing Classes  12288 Westheimer	
AMF Bunker Hill Lanes  925 Bunker Hill	Rd
Amf West Houston Lanes  19936 Saums	Rd
AMF Windfern Lanes  14441 Northwest	Fwy
Amundsen	St
Amy Ridge	Rd
Anderson	Rd
Anderson	St
Anderson Hall	
Anderson Woods	Dr
Andrew	Ln
Andrew	Way
Andrews	St
Andy	Dr
Angleton	St
Anita	St
Annise Parker Campaign  321 Heights	Blvd
Annunciation	St
Ansbury	Dr
Antelope	St
Antha	St
Antoine	Dr
Antoine Health Center  5815 Antoine	Dr
Antoine Kindercare  8703 Antoine	Dr
Antoinette	St
Anzac	St
Apache	Bend
Apache	Point
Apache	St
Apache	Trail
Apache Falls	Dr
Apache Plume	Dr
Apache Way	Dr
Apollo	St
Appalachian	Trail
Apple Knoll	Ct
Appleton	St
Appletree Ridge	Rd
Arabella	St
Arabelle	St
Arapahoe	St
Arbor Oak	Dr
Archdiocese of Galveston-Houston  2403 Holcombe	Blvd
Ardennes	St
Ardmore	
Ardmore	St
Areba	St
Arena	Dr
Ariel	St
Arizona	St
Arizona Fleming Elementary  14850 Bissonnet	St
Arlington	
Arlington	St
Arlington Forest	Dr
Arlington Square	Dr
Armstrong	
Arncliffe	Dr
Arnim	St
Arnot	St
Art	St
Artdale	St
Arthington	Ave
Arthington	St
Arthur	St
Arvana	St
Ascot	Ln
Ash Butte	Dr
Ashburn	Spur
Ashburn	St
Ashcroft	Dr
Ashfield	Dr
Ashford Meadow	Dr
Ashford Point	Dr
Ashland	St
Ashling	Dr
Ashton	
Ashton	Dr
Ashton	Ln
Ashton	St
Ashton Grove	Ln
Ashton Lake	Ln
Ashton Park	Dr
Ashton Pines	Ln
Aston	St
Aston Academy  7070 W 43rd	St
Astoria	Blvd
ATA TAEKWONDO USA  12551 Jones	Rd
Atlantic	St
Atwell	Dr
Atwell	St
Auburn	St
Audley	St
Audubon	Pl
Austin	
Austin	St
Autauga	St
Autumn Flowers	Dr
Autumn Sage	Ln
Ave	
Avenell	Rd
Avenida De Las Americas	
Avenue	
Avenue	R
Avenue of Oaks	St
Averill	St
Aves	St
Avondale	St
Avondale House  3611 Cummins	St
Azalea	Ct
Azalea	St
Azalea Valley	Dr
B Boone School	
Bacher	St
Bagby	St
Bailey	St
Baird	St
Baker	Dr
Baker	Rd
Balbo	
Baldwin	Ave
Balkin	St
Baltimore	St
Bamboo	Rd
Bammel	Ln
Bammel North Houston	Rd
Bammel Westfield	Rd
Bandera	St
Bandlon	Dr
Bandridge	Rd
Baneway	Dr
Banjo	
Banjo	St
Bank	
Bankside	Dr
Banner	Dr
Bannister	Ln
Bantam Ridge	Ct
Banyan	St
Barbara Mae	St
Barberry	Dr
Barker Bluff	Ln
Barker Cypress	Rd
Barker Gate	Ct
Barker Grove	Ln
Barker Lake	Ct
Barker Marsh	Dr
Barker Oaks	Dr
Barker View	Dr
Barker W	Dr
Barker-Clodine	Rd
Barker-Cypress Access	Rd
Barkley	St
Barnett	St
Barr	St
Barringer	Ln
Barrington Fairway	
Barry	Dr
Bartell	Dr
Bassingham	Dr
Bastogne	Rd
Bastrop	
Bastrop	St
Bateswood	Dr
Bathurst	
Bathurst	Dr
Baton Rouge	St
Battleship Texas State Historic Site  3527 Independence	Pkwy
Bauman	Rd
Bauman Road Missionary Baptist Church	
Bay	St
Bay Area	Blvd
Bay Brook Mall	Dr
Bay Hollow	Ct
Bay Isle	Ct
Bay Ledge	
Bay Pines	Dr
Bayberry	Dr
Bayberry Bend Cir	Dr
Baybrook	Mall
Baybrook Mal	
Bayland	Ave
Baynard	Dr
Bayport	Blvd
Bayport	Dr
Baythorne	Dr
BBC Chartering USA Llc  4899 Montrose	Blvd
Beacon	St
Beacon Falls	Dr
Beacon Manor	Ln
Beacon's	View
Beall	St
Beamer	Rd
Beamer Urgent Care  10851 Scarsdale	Blvd
Bean	St
Beatty	St
Beauchamp	St
Beaufort Sea	Dr
Beaumont	Hwy
Beaumont	Pl
Beaumont	Rd
Beaumont	St
Becker	St
Beckley	St
Beckman	St
Bedford	
Bedford	St
Beecher Chiropractic Clinic  1001 Pineloch	
Beechnut	St
Beechnut St  Maplewood Shopping	Center
Beekman	Rd
Beekman Pl	Dr
Beggs	St
Belcrest	St
Beldart	St
Bell	
Bell	Ave
Bell	St
Bellaire	Blvd
Bellaire Chamber of Commerce  6900 S Rice	Ave
Bellaire Gardens	Dr
Bellaire Gardens Apartments  6120 Bellaire	Blvd
Belle Park	Dr
Bellerive	Dr
Bellfort Chase	Dr
Bellfort Pr 1	Dr
Bellfort Pr 4	Dr
Bellfort Village	Dr
Belmark	St
Belneath	St
Belroit	St
Ben Taub General Hospital  1504 Taub	Loop
Benbrook	Dr
Bendell	Dr
Bender	Rd
Benmar	Dr
Bennett	St
Bennie	St
Benning	Dr
Benning Point	Ln
Bennington	
Bennington	St
Bens Branch	Dr
Benson	St
Bentley	St
Bentworth	Dr
Beran	Dr
Beresford	St
Beresford School  2501 W Holcombe	Blvd
Bering Drive Christian School  1910 Bering	Dr
Berkley	
Berkley	St
Berkley Park	Ct
Berkshire	St
Berry	Hill
Berry	Ln
Berry	Rd
Berry	St
Berry Branch	Dr
Berry Brook	Dr
Berry Creek	Dr
Berry Limb	Dr
Berry School  2310 Berry	Rd
Berryhill River Oaks-Catering  Delivery  Restaurant  2639 Revere	St
Bertellis	Ln
Bertha	St
Bertha Alyce Center  5601 S Braeswood	Blvd
Bertner	Ave
Bertwood	St
Bessemer	St
Bethel	Blvd
Betty Boop	St
Beulah	St
Beverly	
Beverly	Dr
Beverly	St
Beverly Hill	St
Beverly Hills	Park
Beverly Hills	St
Beverly Hills	Walk
Beverly Hills Intermediate School	
Beverly Hills Intermediate School  11111 Beamer	Rd
Beverly Hills Swimming Pool  9800 Kingspoint	Rd
Beverly Hills Tennis Courts  Kirkshire	Dr
Beverlyhill	St
Big Bend	Dr
Big Ed's Comedy Defensive Driving School  3804 Fondren	
Bigelow	St
Billingsley	St
Bingham	St
Bingle	Rd
Binz	St
Birdie	Ln
Birnham Woods	Blvd
Bissonnet	St
Black Haw	
Black Oak	Dr
Black Walnut	Dr
Blackbrook	Ln
Blackhawk	Blvd
Blackhawk	Cir
Blackhawk Ridge	Ln
Blalock	Cir
Blalock	Ln
Blalock	Rd
Blalock Forest	St
Blalock Pines	Ct
Blalock Woods	St
Bland	St
Blankenship	Dr
Bliss	St
Blodgett	St
Blossom	St
Blossom Bay	Dr
Blossom Bell	Ln
Blossom Creek	Dr
Blossom Creek	Trail
Blue	Lake
Blue Bell	Rd
Blue Bonnet	Blvd
Blue Bonnet Run	Ct
Blue Lake	Dr
Blue Mesa Ridge	Dr
Blue Oak	Dr
Blue Point	Rd
Blue Ridge	Dr
Blue Ridge	Rd
Blue Ridge Elementary School  6241 McHard	Rd
Blue River	Dr
Blue Swallow	Dr
Blue Water	Ct
Blue Water	Way
Blue Willow	Dr
Blueberry	St
Blueridge	Ct
Blueridge	Rd
Blueridge Baptist Church  9621 Chesterfield	Dr
Bo Wood	
Boardwalk	St
Bob	St
Bob White	Dr
Bobby Lee	Ln
Bobolink	
Boise	
Bolden	St
Bolin	Rd
Bolivia	Blvd
Bolling	Ln
Bomar	St
Bonaire	St
Bonham Elementary School  8302 Braes River	Dr
Bonhomme	
Bonhomme	Rd
Bonita	St
Bonner	Dr
Bonner	St
Bonner School  8100 Elrod	St
Bonner View	Ln
Bonnet Creek	Dr
Bonsrell	St
Booker	St
Booker T Washington Sr High  119 E 39th	St
Boone	Rd
Boone	St
Boone Elementary School  11400 Bissonnet	St
Boone Loop	Dr
Boone Loop	Rd
Booth	St
Borden	St
Borough	Ln
Borough Park	Dr
Bostic	St
Botanica  512 s allen genoa rd suite a south houston tx	
Botany	Ln
Boundary	St
Bow	Ln
Bowen	St
Bowie	St
Box Elder	St
Boyce	St
Boyd	
Brace	St
Brady	
Brady	St
Brae Acres	Rd
Braeburn Glen	Blvd
Braeburn Valley	Dr
Braes Forest	Dr
Braesdale	Ln
Braesmont	Dr
Braesridge	Ct
Braesridge	Dr
Braesvalley	Dr
Braeswood	Blvd
Braeswood	Ct
Braeswood	Square
Braeswood Assembly Of God  10611 Fondren	Rd
Braeswood Park	Dr
Braewick	Dr
Braewood Glen	Ln
Branch Forest	Dr
Brandon	St
Braniff	St
Branson Park	Ln
Brazos	
Brazos	Ave
Brazos	St
Brazos School for Inquiry and Creativity Gano  4637 Gano	St
Brazos School for Inquiry and Creativity Northwest  8787 N Houston Rosslyn	Rd
Brazos School for Inquiry and Creativity Southwest  6210 Rookin	St
Breech	
Breen	Dr
Breen	Rd
Breeze	St
Breezeway	St
Bremond	St
Brentwood	Dr
Brentwood	Park
Brentwood Baptist Church	
Brentwood Baptist Church SBC  13033 Landmark	St
Brentwood Park	Dr
Breton Ridge	St
Bretshire	Dr
Bretton	Dr
Brewster	St
Briar	
Briar Forest	Dr
Briar Oaks	Ln
Briar Ridge	Dr
Briarcrest	Dr
Briarfield	Dr
Briarhurst	Dr
Briarpark	Dr
Briarpark	Ln
Briarwild	Ln
Bricker	St
Bridge Park	Dr
Bridgeland	Ln
Briefway	Ave
Brierley	Ln
Brigade	
Bringhurst	St
Brinkley	St
Brinkman	Ct
Brinkman	St
Brisbane	St
Briscoe	St
Bristol	
Bristol	St
Brittmoore	Rd
Broad	St
Broad Haven	Dr
Broad Oaks	Cir
Broad Oaks	Ct
Broad Oaks	Dr
Broad Pine	Dr
Broad Ridge	Rd
Broad Ripple	Dr
Broadgreen	Dr
Broadlawn	Dr
Broadmoor	St
Broadview	Dr
Broadway	
Broadway	Ave
Broadway	St
Broadway Baptist Church  7300 Lawndale	St
Broadway Baptist Church/ The New Broadway Church  7300 Lawndale	St
Broadway Church-The Nazarene  2711 Broadway	St
Broadway Park Apartments  2505 Broadway	St
Brock	St
Brock Elementary School  1417 Houston	Ave
Brock Park	Blvd
Brock Park	Dr
Brock Park  8201 John Ralston	Rd
Brock Park Golf Course Snack  8201 John Ralston	Rd
Brockley	Ln
Bronson	St
Bronze Sunset	Ct
Brook	St
Brook Forest	Dr
Brook Forest	Trail
Brook Grove	Dr
Brook Lea	St
Brook Shadow	Dr
Brook Shore	Ct
Brook Spring	Dr
Brook Stone	Dr
Brook Village	Rd
Brookdale	Dr
Brookfield	Dr
Brookglade	Cir
Brookglen	Dr
Brookhaven	St
Brooklet	Dr
Brookmeade	Dr
Brookmere	Dr
Brooks	
Brooks	St
Brookside	Dr
Brookston	
Brookwoods	Dr
Brown and Root-Clinton Heliport	
Browncroft	St
Brownie Campbell	Rd
Brownsville	St
Brownwood	St
Broyles	St
Brumbley	St
Brun	St
Buckboard	Dr
Buckle	Ln
Buckle Berry	Way
Buena Vista	St
Buescher	Dr
Buffalo Speedway	
Bungalow	Ln
Bunker Hill	Cir
Bunker Hill	Rd
Bunker Hill Kindercare  937 Bunker Hill	Rd
Bunker Hill Municipal Court  11977 Memorial	Dr
Bunker Hill School  11950 Taylorcrest	Rd
Bunker Hill Village City Hall  11977 Memorial	Dr
Bunker Ridge	Dr
Bunker Ridge	Rd
Bunker Wood	Ln
Burbank	St
Burden	St
Burdine	
Burdine	St
Burkett	St
Burma	Rd
Burman	St
Burnett	St
Burning Tree	
Burning Tree	Ct
Burning Tree	Dr
Burning Tree	Rd
Burnside	Ln
Burnt Amber	Ln
Burr	St
Burr Oak	Dr
Business Center	Dr
Bute	St
Butte Creek	Rd
Buttercup	St
Buxley	St
C C B  School  Houston  TX  9891 Long Point	Rd
C E King	Pkwy
C Y Fair OSM  13300 Hargrave	Rd
Caddo	Rd
Cage	St
Calais	Rd
Calendar	St
Calgary	
Calgary	Ln
Calhoun	Rd
Calhoun Lofts	
California	
California	St
Calle Cordoba Way	Pl
Calles	St
Camay	Dr
Cambridge	
Cambridge	Dr
Cambridge	St
Cambridge Bay	Dr
Cambridge Dale	Ct
Cambridge Eagle	Dr
Cambridge Glen	Dr
Cambridge Oaks	Cir
Cambridge Oaks Apartment	
Cameo	Dr
Campbell	
Campbell	Rd
Campbell	St
Camway	St
Camwood	St
Canadian	St
Canal	Ct
Canal	St
Candlegreen	Ln
Candleshade	Ln
Candlewood Suites Extended Stay Hotel Houston Park Row  19998 Park Row	Dr
Canfield	St
Canino	Rd
Canniff	Rd
Canniff	St
Cannock	Rd
Canyon Mills	Dr
Canyon Rose	Ln
Canyon Springs	Dr
Caperton	St
Capital	Ct
Capital	St
Capital Park	Dr
Capital Park	Way
Capitol	
Capitol	St
Capitol Heights	Dr
Caplin	St
Care Free Pool Service  19111 Plum Bough	Ct
Carew	St
Cargill	St
Carlsbad	St
Carmel	Ave
Carmel	Cir
Carmel	Grove
Carmel Cove	Ct
Carmel Dale	Ln
Carmen	St
Carolee Booker Elementary School  22352 Imperial Valley	Dr
Carolina	St
Caroline	
Caroline	St
Carolwood	Dr
Carothers	St
Carousel	Ln
Carr	St
Carrollton Creek	Ct
Carrollton Creek	Ln
Carrolton	St
Carvel	Ln
Carver	Rd
Cascade Pines	Dr
Cashel Castle	Dr
Castle Crest	Dr
Castle Ct	Pl
Castle Heath	Ln
Castle Ln	Dr
Castlecreek	Ln
Castor	Dr
Castor	St
Cathedral	Dr
Cather	St
Catherine	St
Catherwood	Ln
Catherwood	Pl
Catina	Ln
Cavalcade	St
Caylor	St
Cayton	St
Cebra	St
Cedar Creek	Dr
Cedar Gap	Ln
Cedar Knolls	Dr
Cedar Mesa	Dr
Cedar Post	Ln
Cedar Post	St
Cedar Sun	Trail
Cedardale	Dr
Cedarhurst	Dr
Cedarwood	
Cedel	Dr
Centennial	Dr
Center	Dr
Center	St
Center Park	Rd
Center Point	Dr
Centerfield	Dr
Centerfield	Rd
Centerpark	Dr
Centerwood	Dr
Central	St
Central Green	Blvd
Centre Oaks	Dr
Cesar Chavez	Blvd
Cesar E  Chavez High School  8501 Howard	Dr
Cetti	St
Chadwick	St
Chaffin	St
Champion Forest	Dr
Champions	Dr
Champions Centre	Ct
Champions Plaza	Dr
Chanay	Ln
Chanteloup	Dr
Chantilly	Ln
Chapman	
Chapman	St
Chapman Glen	Dr
Charles	St
Charleston	
Charleston	St
Charleston Park	Dr
Charter Bank Bldg Heliport	
Charter Bay	Dr
Charter Oaks	Dr
Charter Pine	St
Charter Ridge	Dr
Charter Rock	Dr
Chartres	St
Chase Lake	Dr
Chasewood	Dr
Chateau Forest	Dr
Chatwood	Dr
Chaucer	Dr
Cheeves	Dr
Chelton	St
Chenevert	St
Cherbourg	Rd
Chesswood	Dr
Chesterfield	Dr
Chestnut	St
Chestnut Grove	Ln
Chestnut Ridge	Dr
Chestnut Ridge	Rd
Chestwood	Dr
Chevy Chase	Dr
Chew	St
Chickering	St
Children First Academy of Houston  7803 Little York	Rd
Children's Arena LLC  7324 SW	Fwy
Chimney Rock	Rd
Chimney Rock Center  6300 Chimney Rock	Rd
Chimney Rock Central	Blvd
Chipman	Ln
Chiswick	Rd
Christian School of Northwest Houston  6720 W Tidwell	Rd
Christus St Catherine Hospital  701 S Fry	Rd
Christus St Joseph Hospital	
Christus St Joseph Hospital  1919 La Branch	St
Chun	Ln
Church	Rd
Church of God in Christ	
Church of God in Christ  4022 Rutland	St
Cinderella	St
Cinnamon	Ln
Circle Park	St
City	Ct
City Office Furniture  9430 Harwin	Dr
City W	Blvd
Claiborne	St
Claremont Garden	Cir
Clarence	St
Clarewood	Dr
Clarewood Oak Estates	Ln
Clark	
Clark	Rd
Clark	St
Clarks Daycare  5880 W Gulf Bank	Rd
Clay	Ave
Clay	Rd
Clay	St
Clay Brook	Dr
Clay Creek	Dr
Clay Hill	Dr
Clay's Golf Shack  Loch Katrine	Ct
Claymoore Park	Dr
CLC BLVD Bike	path
Clear Lake	Loop
Clear Lake City	Blvd
Clear Lake City BLVD Bike	Path
Clear Lake City Recreation Center  14902 Penn Hills	Ln
Clear Lake City Recreation Center  16511 Diana	Ln
Clear Lake City Recreation Center  404 Woodcombe	Dr
Clear Lake ER  2409 Falcon	Pass
Clearbrook	Dr
Clearbrook	Ln
Clearwood	
Clearwood	Dr
Clearwood	St
Clearwood Crossing	Blvd
Clearwood Landing	Blvd
Cleburne	St
Clematis	Ln
Clement	St
Clemwood	Ln
Cliffwood	Dr
Clifton	St
Clinton	Dr
Clinton Park	St
Clinton Park Elementary School  158 Mississippi	St
Clinton Park Methodist Church  201 Calloway	St
Clinton Skatepark	
Clinton-Wayside	
Clinton-Wayside	Dr
Clover	Dr
Clover	Ln
Clover	Ridge
Clover	St
Clover Creek	Dr
Clover Gardens	Dr
Clover Trail	Ln
Clover Valley	Dr
Club Creek	Dr
Club Z   Apt 2303  13504 Schroeder	Rd
Coach Lamp	Ct
Coach Lamp	Ln
Cobalt	St
Cochran	St
Coffee	St
Coke	St
Colfax	St
Colleen	Rd
Colleen Meadows	Cir
Colleen Woods	Cir
College	Ave
College Green	Dr
College Houston  3190 Main	St
Colley	St
Collingsworth	St
Colonel Fisher	Blvd
Colony	St
Colony Heath	Ln
Colquitt	St
Colt	
Colt	Ln
Colt Canyon	Ln
Colton	St
Columbia	St
Colvin	St
Comal	St
Comfort Suites  11440 Clay	Rd
Commerce	Ave
Commerce	St
Commerce Creek	Dr
Commerce Park	Dr
Common	St
Commonwealth	St
Commonwealth Institute-Funeral  415 Barren Springs	Dr
Community College	Dr
Community Services-sec  4610 E Crosstimbers	St
Concentra Medical Center  6545 Southwest	Fwy
Concentra Urgent Care  9321 Kirby	
Concentra Urgent Care-Hillcroft Houston  6545 Southwest	Fwy
Concentra Urgent Care-Katy Freeway Houston  12345 Katy	Fwy
Concentra Urgent Care-McCarty Houston  8799 N	Loop
Concentra Urgent Care-Northwest 290 Houston TX  6360 West Sam Houston	Pkwy
Concho	St
Concord	St
Concord Park	Dr
Condor	Way
Conger	St
Congregation Emanu El  1500 Sunset	Blvd
Congress	Ave
Congress	St
Conklin	St
Connecticut	St
Conrad Sauer	Dr
Conroe Bible Fellowship Church  6630 Winding Trace	Dr
Constellation	Ln
Consulate General of Spain  2400 Augusta	Dr
Consulate General of Sweden  2401 Fountain View	Dr
Consulate General of Sweden  2909 Hillcroft	St
Contemporary Services Corporation  1 Reliant	Park
Convent of the Good Shepherd	
Converse	St
Cook	Rd
Coolwood	Dr
Coppertree	Ln
Cora	St
Coral Cove	Ct
Coral Sands	Dr
Corbin J  Robertson Stadium  3875 Holman	St
Cordell	St
Corder	Ave
Corinthian Pointe	Dr
Cornell	St
Cornell Park	Ct
Corona Del Mar	Dr
Corona Del Mar Beach Properties  10998 S Wilcrest	Dr
Coronado	
Corporate	Dr
Corpus Christi	St
Corpus Christi Catholic Church  9900 Stella Link	Rd
Corpus Christi Catholic School	
Corpus Christi Catholic School  4005 Cheena	Dr
Corta Calle	Dr
Cortlandt	St
Cosby	St
Costa Mesa	Dr
Costa Rica	Rd
Cotillion	Dr
Cotswold	
Cottage	
Coulcrest	Dr
Coulson	Cir
Coulson	St
Count	St
Country Brook	Ct
Country Club	Dr
Country Creek	Dr
Country Pl	Dr
County	Road
County Fair	Dr
Course	Dr
Court	Rd
Court	St
Court Glen	Dr
Courtney	St
Coventry Square	Dr
Covington	Dr
Coyle	
Coyridge	Ln
Crane	St
Crawford	
Crawford	Rd
Crawford	St
Crawford Elementary School  1510 Jensen	Dr
Creager	St
Creek	
Creek	Dr
Creek	Ln
Creek Bend	Dr
Creek Bend	Trail
Creek Meadow	Dr
Creekbend	Dr
Creekmont	Dr
Crenshaw	Rd
Crescent Gate	Ln
Crescent Green	Dr
Crescent Park	Dr
Cresline	St
Crest Lake	Dr
Crest Park	Dr
Crestdale	Cir
Crestdale	Dr
Crested Butte	Ct
Crestmont	
Crestview	Dr
Crestview	Trail
Crestville	St
Crestwood	Dr
Crestwood Estates	Dr
Cripple Brook	Ct
Cripple Creek	Ct
Cripple Creek	Dr
Cripple Creek	Ln
Crites	St
Crocker	St
Crockett	St
Croft	Ct
Crofton	St
Cromwell	St
Crooked Creek	Dr
Crooker	Center
Crooks Way	Ct
Croquet	Ln
Crosby	St
Cross Grove	Ln
Crosstimbers	
Crosstimbers	Rd
Crosstimbers	St
Crossview	Dr
Croton	Rd
Crown	St
Crowne Plaza  14703 Park	Row
Cry Baby	Ln
Crystal Bay	Dr
Crystal Meadow	Pl
Crystal Springs	Dr
Culberson	St
Cullen	Blvd
Cullen	Cir
Cullen	St
Cullen Hall	
Cullen Middle School  6900 Scott	St
Cullen Park  19008 Saums	Rd
Cullen Performance Hall  1 Main	St
Culmore	Dr
Cumberland	St
Cummins	St
Curry	Rd
Cushing	St
Cy Fair Plastic Surgery  James Tang MD  11302 Fallbrook Drive  Suite	
Cy-Fair Christian Church  9730 Grant	Rd
Cy-Fair Church of the Nazarene	
Cy-Fair Medical Partners- Willowbridge Professional Square  10028 W	Rd
Cy-Fair Montessori School  11411 Windfern	Rd
Cypress Fairbanks Medical Center Hospital  10655 Steepletop	Dr
Cypress Fairbanks Schools  11330 Falcon	Rd
Cypress Family Fellowship  17330 W Little York	Rd
Cypress Willow	Dr
Cypress-Fairbanks Independent School District  Windfern High School	
Cyr	
D S Bailey	Ln
Dabney	St
Dacca	Dr
Dacoma	St
Daffodil	
Dagg	Rd
Dairy Ashford	Rd
Dairy Ashford	St
Dairy Ashford Roller Rink  1820 S Dairy Ashford	St
Dairy View	Ln
Daisey Bell	Ln
Daisy	St
Dalecrest	Dr
Dalewood	Dr
Dallas	
Dallas	Rd
Dallas	St
Dallas Acorn	St
Dallas Theological Seminary  6000 Dale Carnegie	Ln
Dalmatian	Dr
Dalview	Ave
Damascus	Dr
Dance Houston  406 W Clay	
Danford	Dr
Danshire	Ct
Danshire	Dr
Daphne	St
Darby	Cove
Darby	Ln
Darby	Loop
Darby Mill	Ln
Darby Rose	Ln
Darby Square	Tr
Darden	St
Darien	St
Darling	St
Darlinghurst	Dr
Darnay	Dr
Dart	St
Dashwood	Dr
Dashwood	St
Daugherty	St
Davenport	St
Davis	St
Dawnwood	Dr
Dawson	Ln
Dawson Mill	Ct
Day	
De Boll	St
De Haven	St
De Koven	St
De Leon	St
De Lozier	St
De Milo	Dr
De Moss	Dr
De Priest	St
De Soto	St
Deanna	
Deanwood	St
Dearborn	St
Debra	Ln
Debra	Rd
Debra Terrace	Ct
Decatur	St
Dee's Tutoring Center and Childcare  3919 Cheryl Lynne	Ln
Deep Forest	Cir
Deep Forest	Dr
Deep Glen	Ln
Deep Valley	Dr
Deepcreek	Ln
Deer Meadow	Dr
Deering	Dr
Defender	St
Dekaney High School  22351 Imperial Valley	Dr
Del Glen	Ln
Del Mar Lanes  3020 Mangum	Rd
Del Papa	St
Del Prado	Dr
Del Rio	St
Delano	St
Delbury	St
Dell	Ct
Delmar	St
Delmar Stadium  2020 Mangum	Rd
Den Oak	Dr
Denison	St
Denman	Rd
Denmark	Rd
Dennis	
Dennis	St
Denton	St
Depriest	St
Depriest Ministries  10201 Raymondville	Rd
Derby	Dr
Des Chaumes	Ct
Des Chaumes	St
Des Jardines	St
Desert Rose	Ln
Desert Sage	Dr
Detering	
Detering	St
Detroit	St
Deussen	Pkwy
Dewitt	Rd
Dexter	Rd
Diana	Ct
Diana	Ln
Diane	Ln
Dickerson	St
Dickinson	Ave
Dickinson	Rd
Dickson	St
Dieppe	St
Dierker	Dr
Dillard	St
Dillon	St
Diplomat	Way
Dipping	Ln
Dismuke	St
Dixie	Dr
Dixie Drive Baptist Church  7112 Dixie	Dr
Dixie Farm	Rd
Dixie-Ardmore	
Dockal	Rd
Dodson	Rd
Dodson	St
Dodson Lake	Park
Dodson School  1808 Sampson	St
Dogwood Blossom	Trail
Doherty Library	
Dolly Wright	Ave
Dolly Wright	St
Dolores	St
Dominion Academy Charter School  1102 Pinemont	Dr
Don P Killough Middle School  7600 Synott	Rd
Donlen	St
Donovan	St
Doolittle	Blvd
Dorchester	St
Dorchester Forest	Ln
Dorrington	St
Dorsett	
Dorwayne	Ct
Douglas	St
Doulton	Dr
Dover	St
Dow	Park
Dow	Rd
Dow II Park  200 W Nellis	Rd
Dow Park Number	
Dow School	
Dowling	St
Dowling Middle  14000 Stancliff	St
Dowling Middle School  14000 Stancliff	St
Dowling Pk To 8 Relief  4400 W 18th	St
Downwood Forest	Dr
Dr  Judith Kanzic  7702 Westview	Dr
Draco	
Draco	St
Dragonwick	Dr
Drew	St
Dreyfus	St
Driscoll	St
Drouet	St
Droxford	Dr
Drv Downtown Houston Aquarium	
Duane	St
Dublin	St
Duchamp	Dr
Duff	Ln
Duller	Ln
Dumas	St
Dumble	St
Dumfries	Dr
Dunham	Dr
Dunham	Rd
Dunlap	
Dunlap	St
Dunlavy	St
Dunlop	St
Dunvale	Rd
Dunvegan	Way
Dupont	St
Durban	Dr
Durham	
Durham	Dr
Durham Chase	Ln
Durham Elementary School  4803 Brinkman	St
Durham Manor	Ln
Dwight	St
Dwight D Eisenhower High Schl  7922 Antoine	Dr
Dwight D Eisenhower Park  13400 Aqueduct	Rd
Dyna	Dr
E Parker	Rd
Eagle	Landing
Eagle	Pass
Eagle	St
Eagle Creek	Dr
Eagle Pass	St
Earline	St
East	
East	Dr
East	Fwy
East	Ln
East	Loop
East Freeway  12001 East	Fwy
East Loop	Fwy
East Sam Houston	Pkwy
Eastbourne	Dr
Eastbrook	Dr
Eastcape	Dr
Easter	St
Eastex	Dr
Eastex	Fwy
Eastex Freeway	Fwy
Eastex Freeway Service	Rd
Eastex Freeway Volunteer Fire Dept	
Eastex Frwy Serv	Dr
Eastex Frwy Service	Rd
Eastex Oaks Church	
Eastex Pr 1	Dr
Eastgate	St
Easthaven	Blvd
Easthaven	Dr
Easthaven Baptist Church  13100 Beamer	Rd
Eastlake	
Eastlake	Ct
Eastland	St
Eastman	St
Easton	St
Eastside	St
Eastside Free Will Baptist Church	
Eastwood	Cir
Eastwood	Park
Eastwood	St
Eastwood Academy  5100 Polk	St
Eastwood Academy High School  1315 Dumble	St
Eastwood Lake	Ct
Eastwood Skatepark	
Eastwood Tc 2	Dr
Easy	St
Ebbtide	Dr
Echo Glen	Dr
Eddington	St
Eddystone	Dr
Edell	St
Edgar Odell Lovett College	
Edgebrook	
Edgebrook	Dr
Edgecreek	Dr
Edgehill	Rd
Edgemoor	Dr
Edgewood	
Edgewood	St
Edgeworth	St
Edison	St
Edloe	Rd
Edloe	St
Edloe-Driveway	
Edna	St
Edsee	St
Edward	Dr
Edward H White School  9001 Triola	Ln
Edwards	St
Egypt	St
Eigel	St
Eisenhower Ninth Grade School  3550 W Gulf Bank	Rd
El Buey	Way
El Camino	St
El Camino Del Rey	St
El Camino Real	
El Camino Village	Dr
El Dorado	Blvd
El Dorado	Dr
El Dorado Oaks	Ct
El Dorado Oaks	Dr
El Paseo	St
El Paso	St
El Rancho	St
Elbert	St
Elder	
Elder	St
Elder Glen	Dr
Elder Vista	Cir
Elder Vista	Dr
Eldorado Centre	Ln
Eldridge	Pkwy
Eldridge	Rd
Eldridge	Way
Eldridge Chase	
Eldridge Glen	Dr
Eldridge Park	Way
Eldridge Pl	Dr
Eldridge Springs	Way
Eldridge Valley	Dr
Eleanor	St
Electra	Dr
Elgin	Ct
Elgin	St
Elizabeth Glover	Park
Elkins	Rd
Ella	Blvd
Ella	Cir
Ella	Pl
Ella Boulevard High School  12525 Ella	Blvd
Ella Lee	Ln
Ellington	St
Elm	
Elm	St
Elm View	Cir
Elmora	St
Elmside	Dr
Elmview	Dr
Elmview	Pl
Elmview Trace	Ln
Elmwood	Ct
Elrod	St
Elser	St
Elton	St
Elvera	St
Elwood	St
Elysian	St
Emanuel Memorial	Park
Emerald Oaks	Dr
Emmanuel Church of God in Christ  8813 Lockwood	Dr
Emmanuel Deliverance Temple  4718 Littlecrest	Rd
Emnora	Ln
Emporia	St
Enclave	Pkwy
Endicott	Ln
English	St
Enid	St
Ennis	St
Eppes	St
Epsom	Rd
Erath	St
Erby	Ave
Erby	St
Erie	
Erie	St
Erin	Ct
Erin	Dr
Erin	St
Erin Cove	Ct
Erin Creek	Ct
Erin Dale	Ct
Erin Knoll	Ct
Erin Way	Ct
Ernestine	St
Eskridge	St
Esperanza	
Esperanza	St
Esperanza School  1100 Roy	St
Esther	
Esther	Dr
Ethel	St
Ethel Mosley Young Elementary School  3555 Bellfort	St
Eubanks	St
Euclid	St
Euel	St
European Wax Center Houston-West University  5154 Buffalo Speedway	
Evans	St
Evanston	St
Evelyn	Cir
Evelyn	St
Ever Green	Ln
Everett	St
Evergreen	Dr
Evergreen	Rd
Evergreen	St
Evergreen	Trails
Evergreen Cliff	Trail
Evergreen Glade	Ct
Evergreen Glade	Dr
Evergreen Grove	Dr
Evergreen Pl	Dr
Evergreen Ridge	Way
Evergreen Valley	Dr
Ewing	St
Ewing Irrigation  1935 Spring Cypress	Rd
Ewing Irrigation  22403 Katy	Frwy
Ewing Irrigation  5260 Brittmore	Rd
Ewing Irrigation  615 N Houston	Ave
Ewing Irrigation  700 W Davis	St
Exeter	St
EZ TAG Store-Westpark Area  4012 S Dairy Ashford	
Ezekiel W  Cullen Bldg	
F M 1960 Pediatric Center  1250 Cypress Station	Dr
F R Duke Farm Airport	
F S Robertson Corporation  4605 Post Oak Place	Dr
F-M 1960	Rd
Fair Forest	Dr
Fair Meadow	Ln
Fair Oaks	Rd
Fair Park	Dr
Fairbanks	St
Fairbanks N Houston	Rd
Fairbury	Dr
Fairdale	Ln
Fairgrove Park	Dr
Fairland	Dr
Fairview	
Fairview	St
Fairview Forest	Dr
Fairview Park	Dr
Fairview Valley	Ct
Fairway	Ct
Fairway	Dr
Fairway Green	Dr
Faithon P Lucas Sr	Blvd
Fall Briar	Dr
Fallbrook	
Fallbrook	Dr
Fallbrook Baptist Church	
Fallbrook Church  12512 Walters	Rd
Fallen Oaks	Dr
Falvey	St
Fannin	
Fannin	Rd
Fannin	St
Fannin School	
Far Seas Grill The  Ste 2  17756 Katy	Fwy
Fargo	St
Fargo Woods	Cir
Fargo Woods	Dr
Farm to Market	
Farm to Market	Road
Farm to Market 1960	
Farm to Market 1960	Rd
Farm to Market 1960 West	Rd
Farm To Market Road 1960	
Farm-to-Market	
Farm-To-Market	Road
Farm-To-Market Road	Highway
Farm-To-Market Road 1960	
Farm-To-Market Road 2351	
Farm-To-Market Road 2553	
Farm-To-Market Road 526	
Farmer	St
Farnham	St
Faulkner	St
Fauna	St
Fauna Woods	Ct
Fawndale	Ln
Featherwood	Dr
Federal	Rd
Federal Plaza	Dr
Feeder	Rd
Feeder	Trail
Feldspar	St
Fennel	Dr
Fennell	St
Ferdinand	St
Ferguson	Way
Fern	Dr
Fern Creek	Ln
Fern Terrace	Dr
Ferris	Dr
Ferris	St
Ferris Airport	
Fidelity	St
Field Brook	Dr
Field Cottage	Ln
Field House	Ct
Field Mowers of Houston	
Field of Greens  2320 W Alabama	St
Fields	St
Fighting Colt	St
Finch	St
Findlay	St
Firefly	St
Firnat	
Firnat	St
Firnat Missionary Baptist Church  9132 Firnat	St
First Call Field Service  Inc   15531 Kuykendahl	Rd
First Choice Field Services  11600 Jones	Rd
Flagship	Dr
Flagstone	Terrace
Flamingo	Dr
Flaxman	St
Fleetwood	St
Fleming	
Fleming	Ct
Fleming	Dr
Fleming	Park
Flintridge	Dr
Flora	St
Flora Morgan	Ln
Flora Vista	Dr
Flowers	St
Floyd Hoffman Middle School  6101 W Little York	Rd
Fm 1959	Rd
FM 1960	
Fm 1960	Rd
FM 2351	Rd
FM 529	Rd
FM1960	
Folger	
Fondren	Cir
Fondren	Rd
Fondren Bend	Dr
Fondren Elementary School  12405 Carlsbad	St
Fondren Lake	Dr
Fondren Library	
Fondren Meadow	Dr
Fondren Middle School	
Fondren Middle School  6333 S Braeswood	Blvd
Fondren Pl	Dr
Fondren School  12405 Carlsbad	St
Fondren Village	Dr
Fonmeadow	Dr
Forbes	Rd
Force	St
Forest	Blvd
Forest	Dr
Forest	Ln
Forest	St
Forest	Way
Forest Brook High School  7525 Tidwell	Rd
Forest Cove	Dr
Forest Heights	Dr
Forest Hill	Blvd
Forest Hollow	St
Forest Oaks	Blvd
Forest Park East Cemetery  21620 Gulf	Fwy
Forest Shores	Dr
Forestwood	Dr
Bellfort	Ave
Fort Bend	Road	
Ft Bend	Rd
Fort Houston	Dr
Fort Sam Houston Branch Post Office  3600 Fort Sam Houston	
Fort Sumter	Ct
Fort Sumter	Ln
Forum Park	Dr
Forum Pl	Dr
Forum W	Dr
Fountain	St
Fountain View	Dr
Fourcade	St
Foxcroft	Ln
Foxridge	Dr
Foxwood Forest	Blvd
Foxwood Forest	Ct
Frail	Ln
Francis	St
Franklin	Rd
Franklin	St
Franklin Avenue Baptist Church  6711 Long Point	Rd
Franklin School  7101 Canal	St
Frawley	
Frawley	St
Free	Ln
Free At Last Club  3601 Lydia	St
Free Will Missionary Baptist Church  3821 McKinley	St
Freeman	St
Freeport	St
Freestone	St
Freeway Baptist Church	
Freeway Baptist Church  8702 Kingspoint	Rd
Freeway Manor Baptist Church  2300 Rodney	St
Freeway Service	Dr
Freeway Service	Rd
French Village	Dr
Freshmeadows	Dr
Frey	Rd
Friendly	Rd
Frio	St
Friobend	Ln
Frisco	St
Frontage	Road
Frwy Serv	Dr
Fugate	St
Full Out Dance  13455 Cutten	Rd
Fulton	St
Fulton Meadows	Ln
Fuqua	
Fuqua	Ct
Fuqua	Dr
Fuqua	Gardens
Fuqua	St
Fuqua Gardens	Dr
Fuqua Gardens	View
Fuqua Gardens View	Rd
Fuqua Pr 2	Dr
Fuqua Villas	Ln
Fur Market	Dr
Furman	Rd
Fwy HOV	
Gaffney	Ln
Gail Reeves	Park
Galaxy	St
Gale	St
Galling	Dr
Galveston	
Galveston	Ave
Galveston	Rd
Galveston Bay Estuary Program  17041 EI Camino Real	
Galveston Real Estate-Chris Downing  14906 FM 529 Suite	
Gammon	Dr
Gano	St
Garden	Rd
Garden City	Dr
Garden City School	
Garden Crest	Ln
Garden Gale	Ln
Garden Gate	Way
Garden Grove	Dr
Garden Lake	Dr
Garden Oaks Baptist Church  3206 N Shepherd	Dr
Garden Spa  7731 Southwest	Fwy
Garden Stream	Ct
Gardendale	Dr
Garfield	
Garland	Dr
Garland	Rd
Garland	St
Garlenda	Ln
Garrow	St
Gary	St
Gasmer	Dr
Gate 1	Rd
Gate 2	Rd
Gatebrook	Dr
Gates	St
Gatlin	Ln
Gatlinburg	Dr
Gatling	Ct
Gears	Rd
Gellhorn	Dr
Gellhorn Pad Heliport	
Gemini	Ave
Gemini	St
Gena Lee	Dr
Genard	Rd
Gene Green Beltway 8 Park  6500 East Sam Houston	Pkwy
General Services Bldg	
Genesee	St
Genoa Red Bluff	Rd
Gentry	St
George Bush Intercontinental Airport  3500 N Terminal	Rd
George Bush Intercontinental Airport (IAH)  2800 N Terminal	Rd
Georgetown Park	Ct
Georgetown Park	Dr
Gessner	Dr
Gessner	Rd
Gessner Medical Clinic  8720 S Gessner	Dr
Get it Done CDL  5523 Brunswick	
Gibbs	St
Gillespie	Ct
Gillespie	Rd
Gillespie	St
Gillette	St
Gilpin	St
Gineridge	Dr
Glade Valley	Dr
Gladstone	St
Gleason	Rd
Glen	Dr
Glen Lake	Dr
Glen Lee	Dr
Glen Valley	Dr
Glen Willow	Rd
Glenbrae	St
Glencoe	St
Glencrest	Ave
Glencrest	St
Glenda Dawson High School  2050 Cullen	Blvd
Glendale	St
Glenhurst	Dr
Glenlea	St
Glenloch	Dr
Glenmeadow	Dr
Glenmont	Dr
Glenmont	St
Glenmore	Dr
Glenview	Dr
Glenwest	Dr
Globe	St
Glover	St
Glover Meadows	Ln
Go Man Go	Dr
Gober	St
Godwin	St
Goforth	St
Gold Mesa	Ct
Gold Mesa	Trail
Goldcrest	St
Golden Bear	Ln
Golden Bend	Dr
Golden Brook	Dr
Golden Field	Dr
Golden Forest	Dr
Golden Gate Baptist Church  4358 Mallow	St
Golden Meadow	Dr
Golden Sands	Dr
Golden Star	Dr
Golden View	Dr
Golden Wood	Ln
Golf Link	Pl
GolfTEC Upper Kirby  2615 SW	Freeway
Gonzales	St
Good Day	Dr
Good Shepard  10802 Montverde	Ln
Good Shepherd Baptist Church  7818 Bonaire	St
Good Shepherd Episcopal School  2929 Woodland Hills	Dr
Good Shepherd Methodist Church  333 Mercury	Dr
Good Shepherd Missionary Baptist Church	
Goodson	Dr
Goodson Honda	
Gould	St
Governors	Cir
Graceland	St
Grafton	St
Grafton Bridge	Ln
Grahamcrest	Dr
Grand	Pkwy
Grand Brook	Dr
Grand Field	Ct
Grand Flora	Ct
Grand Heights	Ct
Grand Jct	Dr
Grand Parkway Association  4544 Post Oak Place	Dr
Grand Plaza	Dr
Grand Saline	Dr
Granite	St
Grant	Ave
Grant	Rd
Grant	St
Grant G G  970 Glen	Ave
Granville	Dr
Grape	St
Grapevine	St
Gray	St
Gray Falls	Dr
Gray Hawk	Dr
Gray Jay	Ct
Gray Jay	Dr
Gray Moss	Ln
Gray Oaks	Dr
Gray Ridge	Dr
Greater Emmanuel Family Worship Center  3915 Kelley	St
Greater Mt Carmel Missionary Baptist Church  8403 Crestmont	St
Greater Mt Lebanon Baptist Church  2324 Lockwood	Dr
Green	Dr
Green	Ln
Green	Rd
Green	St
Green	Vista
Green Ash	Dr
Green Butte	Ct
Green Castle	Way
Green Creek	Dr
Green Crest	Dr
Green Lawn	Dr
Green Meadow	Ln
Green Mountain	Dr
Green Pear	Ln
Green Point	Ct
Green River	Dr
Green Tree	Ct
Green Tree	Park
Greenbriar	Dr
Greenbriar	Park
Greenbriar	St
Greenbriar  7777 Greenbriar	St
Greenbriar Bldg	
Greenbriar Colony	Dr
Greenbriar Plaza	Dr
Greenbriar Point	Ln
Greenbriar Springs	Dr
Greenbrook	Dr
Greenfork	Dr
Greenhaven	Ln
Greenhouse	Rd
Greenlake	Dr
Greenpark Manor	Ln
Greenridge	Cir
Greenridge	Dr
Greenridge Baptist Church  15001 Chipman	Ln
Greens	Ct
Greens	Pkwy
Greens	Rd
Greens Bayou	St
Greens Bayou Church of Christ  13805 Wallisville	Rd
Greens Crossing	Blvd
Greens Crossing Church of God	
Greens Landing	Dr
Greenspoint	Dr
Greenspoint	Mall
Greenspoint Baptist Church  11703 Walters	Rd
Greenspoint Park	Dr
Greenstone	St
Greensward	Rd
Greenswarth	Ln
Greenville	St
Greenwich	St
Greenwillow	St
Gregg	St
Gregg Headstart  6701 Roxbury	Rd
Gregg School  6701 Roxbury	Rd
Gregory-Lincoln Education Center  1101 Taft	St
Griggs	Rd
Grimes	St
Groeschke	Rd
Grove Glen	Dr
Grove Park	Dr
Grover	Ln
Groveton	St
Grow	Ln
Guese	Rd
Guest	St
Guest Condo	
Guhn	Rd
Guinevere	St
Gulf	Ave
Gulf	Fwy
Gulf	St
Gulf	Valley
Gulf Bank	Rd
Gulf Bridge	Ct
Gulf Bridge	St
Gulf Coast Driving School-Clear Lake  17329 El Camino Real	
Gulf Creek	Dr
Gulf Freeway Frontage	Rd
Gulf Freeway Service	Rd
Gulf Freeway Srv	Rd
Gulf Frwy Service	Dr
Gulf Meadows	Dr
Gulf Oil Big Creek Field	Rd
Gulf Palms	
Gulf Spring	Ln
Gulf Tree	Ln
Gulfbank	Rd
Gulfbrook	Dr
Gulfcrest	
Gulfton	Dr
Gulfton	St
Gum Grove	Ln
Gunn	Dr
Gustav	St
Gustine	Ct
Gustine	Ln
H	
Hackney	St
Haddington	Dr
Haddon	St
Hadley	
Hadley	St
Hahlo	St
Hain	St
Halifax	St
Hall	St
Hall Croft Chase	Ln
Halmart	St
Halpern	
Halpern	St
Halsey	St
Hamblen	Rd
Hamilton	Cir
Hamilton	St
Hamilton Grove	Ln
Hamilton Middle School  139 E 20th	St
Hamlet	St
Hammerly	Blvd
Hampton	Dr
Handy	
Harbor	
Harbor	St
Harcourt	Dr
Harcourt Bridge	Dr
Hardway	St
Hardwicke	Rd
Hardy	Rd
Hardy	St
Hardy Toll	Rd
Harland	Dr
Harold	St
Harriet	St
Harrington	St
Harrington Cemetery	
Harris	St
Harris County Assessor  6000 Chimney Rock	Rd
Harris County Sheriff's Office-Community Services Division  9111 Eastex	Fwy
Harrisburg	Blvd
Hartford	St
Hartsdale	Dr
Hartsook	St
Hartsville	Rd
Hartwick	Rd
Harvard	St
Harvard Elementary School  810 Harvard	St
Harvest Time	Ln
Harvest Time Church of God in Christ  7515 W Montgomery	Rd
Harwin	Dr
Haviland	Park
Haviland	St
Hawthorne	St
Hayes	Rd
Haygood	St
Hays	St
Hazard	St
Hazelhurst	Dr
HCC Coleman College  1900 Pressler	St
Heaney	Dr
Hearth	Dr
Hearthstone Green	Dr
Heath	Ct
Heath	St
Heath Park	Trail
Heather	Cir
Heather	Ct
Heather	Ln
Heather Brook	Ln
Heather Falls	Dr
Heather Green	Dr
Heather Hill	Dr
Heather Run	Dr
Heather Sage	Dr
Heatherbloom	Dr
Heatherbrook	Dr
Heatherwood	Dr
Heavenly Hands registered Childcare Home  Free meals  no registration fee  6315 Darlinghurst	Dr
Heavy Anchor	Ln
Heffernan	St
Heidrich	Ave
Heights	Blvd
Heiner	St
Helena	
Helena	St
Helmers	St
Helms	Rd
Hemlock	St
Hempstead	Ave
Hempstead	Hwy
Hempstead	Rd
Hempstead	St
Hempstead Villa	Dr
Hendon	Ln
Henke	St
Henninger	St
Henry	
Henry	St
Henson	St
Herald	St
Hereford	St
Herkimer	St
Herman	Dr
Herman	St
Herman Loop	Dr
Herman Pressler	
Hermann	Dr
Hermann	Rd
Hermann Lake	Dr
Hermann Loop	Dr
Hermann Museum Cir	Dr
Hermann Park	Dr
Hermann Park  6001 Fannin	St
Heron	Dr
Hershe	St
Hickok	Ln
Hickory	Hollow
Hickory	Ln
Hickory	St
Hickory Chase	Dr
Hickory Creek	Dr
Hickory Falls	Dr
Hickory Lawn	Dr
Hickory Park	Dr
Hickory Ridge	Ct
Hidalgo	Park
Hidalgo	St
Hidden Arbor	Ln
Hidden Pines	Ct
Hidden Valley	Dr
Hideaway	Cir
High Haven	Dr
High Mountain	Dr
High Star	Dr
High Stone	Ln
High Valley	Dr
Highcrest	Dr
Highland	St
Highmeadow	Dr
Highway	Blvd
Hill Forest	Dr
Hillcroft	Ave
Hillcroft	St
Hillcroft Tc 10	Dr
Hillcroft Tc 2	Dr
Hillcroft Tc 3	Dr
Hillcroft Tc 8	Dr
Hillcroft Tc 9	Dr
Hillmont	St
Hillsboro	St
Hillside Bayou	Dr
Hilton Garden Inn Houston West Katy  2409 Texmati	Dr
Hilton Garden Inn Houston Westbelt  6855 West Sam Houston	Pkwy
Hilton Garden Inn Houston/Bush Intercontinental Airport  15400 John F Kennedy	Blvd
Hinman	St
Hiram Clarke	Rd
Hiram Clarke Tc 1	Dr
Hiram Clarke Tc 2	Dr
Hiram Clarke Tc 3	Dr
Hiram Clarke Tc 4	Dr
Hirsch	Rd
Hirsch	St
Hitchcock	St
HL and P South Houston Helistop	
Hobby (HOU)  8183 Airport	Blvd
Hobby Center Parking Garage  Rusk	St
Hockley	St
Hoffman	St
Hoffman Estates	Blvd
Hogan	St
Hogue	St
Hohford	St
Hohl	St
Hohldale	St
Holcombe	Blvd
Holiday	Ln
Hollister	
Hollister	Dr
Hollister	Rd
Hollister	Ridge
Hollister	Spring
Hollister	St
Hollister Cole	
Hollister Woods	
Hollock	
Hollock	St
Hollow Brook	Dr
Hollow Hook	Rd
Holly Hall	St
Holly View	Dr
Holman	Ct
Holman	St
Holman Street Baptist Church  3422 Holman	St
Holmes	Rd
Holocaust Museum  5401 Caroline	St
Holt	Alley
Holt	St
Homewood	Ln
Homewood Row	Ln
Hon  Dion Ramos  201 Caroline	St
Hondo	St
Honeywell	
Honorable Brock Thomas  1201 Franklin	St
Honorable Diane Bull  1201 Franklin	St
Honorable Elsa Alcala  1307 San Jacinto	St
Honorable Eva Guzman  1307 San Jacinto	St
Honorable Frank Pierce  1201 Franklin	St
Honorable Kevin Fine  1201 Franklin	St
Honorable Mark Kent Ellis  1200 Congress	St
Honorable Michael Schneider  201 Caroline	St
Honorable Mike Miller  4601 Washington	Ave
Honorable Shawna L Reagin  1201 Franklin	St
Honorable Veronica Torres  201 Caroline	St
Hood	St
Hooten	Ln
Hooton	
Hoover	
Hopkins	St
Hopper	Rd
Horn-Katy Hawk International Airport	
Horne	St
Hornwood	Dr
Hoskins	Dr
Housman	
Houston	
Houston	Ave
Houston	Blvd
Houston	Ct
Houston	Dr
Houston	Hwy
Houston	Ln
Houston	Pl
Houston	Rd
Houston	St
Houston	Viaduct
Houston  111 East	Loop
Houston  1200 Travis	
Houston  1921 Preston	St
Houston  1921 W Bell	St
Houston Airpark	
Houston Ballet  1921 Preston	St
Houston Ballet  1921 W Bell	St
Houston Baptist University  7502 Fondren	
Houston Bass Lessons  13505 Westheimer	
Houston Casino Parties  24419 Eagle Haven	Dr
Houston Center	Blvd
Houston Center For Photography  1441 W Alabama	St
Houston Chronicle	Blvd
Houston City Office  16880 5 W Lake Houston	Pkwy
Houston City Office  18301 Lee	Rd
Houston City Office  19409 Sears	Dr
Houston College Funding  5100 Westheimer	Rd
Houston Community College  10041 Cash	Rd
Houston Community College  1550 Foxlake	Dr
Houston Community College  Alief Continuing Education Center  13803 Bissonnet	St
Houston Community College Southwest  Fine Arts and Speech Dept  13645 Murphy Road  Suite	
Houston County Airport	
Houston Elementary School  1000 N Thompson	St
Houston Elementary School  1701 S Hall	St
Houston Environmental Services Center  11500 S Post Oak	Rd
Houston Executive Airport	
Houston Grand Prix  13901 Eastex	Fwy
Houston Gun Club  6700 Mchard	Rd
Houston Heliport	
Houston Independent Schl District  1102 Telephone	Rd
Houston Independent School District  De Chaumes Elementary  155 Cooper	Rd
Houston Independent School District  Durham Elementary  4803 Brinkman	St
Houston Independent School District Library Services  6100 Knox	St
Houston Institute for Culture  708 Telephone	Rd
Houston Irvington Nazarene Church  4413 Edison	St
Houston Masonic Library and Museum  2370 Barker Oaks	Dr
Houston Middle College for Technology  4310 Dunlavy	St
Houston Museum of Natural Science  5555 Hermann Park	Dr
Houston Northwest Foursquare  6730 W Tidwell	Rd
Houston Oaks	Ct
Houston Oaks	Dr
Houston Oil and Minerals Smith Point Heliport	
Houston Police Command Station Heliport	
Houston Police Dept  10201 Telephone	Rd
Houston Police Dept  1200 Travis	
Houston Police Foundation  1200 Travis	
Houston Public Library  500 McKinney	
Houston Rosslyn	Rd
Houston School	
Houston School	Rd
Houston School  2000 W Louisiana	Ave
Houston School  2417 Yonkers	St
Houston School  3923 Henry	St
Houston School of Floral Design  2000 N	Loop
Houston Songshan Shaolin Temple  11698 Bellaire	Blvd
Houston Southwest Airport  503 McKeever	Rd
Houston Temple  1815 N Palace	Ave
Houston TX LDS Institute  5008 Calhoun	Rd
Houston Victory Ministries Church  11255 Eastex	Fwy
Houston Westlake Village  7298 Kings Gate	Cir
Houston Zoo  6200 Hermann Park	Dr
Houston Zoo Inc  6200 Hermann Park	Dr
Houston's Franklin Avenue Baptist  4027 Irvington	Blvd
Houston-southwest (AXH)  503 McKeever	Rd
Houston-Southwest Airport (AXH)  503 Mckeever	
Houston-Southwest Airport (AXH)  503 McKeever	Rd
Houston-Southwest Airport (AXH)  McKeever	Rd
Howard	
Howard	Alley
Howard	Dr
Howard Johnson Inn Suites Hobby Airport  8600 Gulf	Fwy
Howard Keck Hall	
Howard L  Ward	Park
Hub	St
Huffman New Caney	Rd
Huffman-New Caney	Rd
Hughes	
Hughes	Rd
Hughes	St
Huldy	St
Humble Westfield	Rd
Humble-Westfield	Rd
Hunter's Bend	Dr
Hunters Hollow	Dr
Hunters Lake	Ct
Hunters Lake	Way
Hunters Springs	Ln
Hunting Brook	Dr
Huntington	Cove
Huntington Crest	Dr
Huntington Estates	Dr
Huntington Field	Dr
Huntington Glen	Dr
Huntington Hill	Dr
Huntington Pl	Dr
Huntington Venture	Dr
Huntington View	Dr
Huntington Way	Dr
Hunton	Dr
Hurfus	Dr
Hurley	St
Hutchins	
Hutchins	St
Hwy	
Hwy 59	
Hwy 6	
Hyde Park	Blvd
Hyde Park	Crescent
Hyde Park	Pl
Hyde Park Pub  611 Hyde Park	Blvd
I	
I	St
I-10 Feeder	Rd
Idylwood	Dr
Iglesia Bautista Townwood Church	
Iglesia Bautista Townwood Church  14 Broadhurst	Dr
Iglesia Jesus Es El Camino  47 Tidwell	Rd
Ih	
Ilex	St
Imogene	St
Imperial Crown	Dr
Imperial Valley	Dr
Indiana	St
Indianapolis	St
Industrial	Rd
Industrial	Way
Industrial Field Robotics  14619 Marine	Rd
Ingomar	Way
Inlane	St
International Plaza	Dr
International Tours of Houston  6363 Richmond	Ave
Interstate	
Interstate	Highway
Interstate 10 Frontage	Rd
Interstate 10 Service	Rd
Interstate 45	
Interstate 45 Frontage	
Interstate 45 Frontage	Rd
Interstate 45 Fwy HOV	
Interstate 610 HOV	
Intervale	St
Inwood	
Inwood	Dr
Inwood Apartments  5300 W Gulf Bank	Rd
Inwood Aquarium  8244 Antoine	Dr
Inwood N	Dr
Inwood W	Dr
Iola	St
Ipswich	Rd
Iris Lee	Ln
Irma's Southwest Grill  1314 Texas	St
Ironfork	Dr
Irving	Way
Irvington	Blvd
Irvington	Ct
Irvington	Park
Irvington Christian Academy  113 Coronado	St
Irvington Pentecostal Church  4400 Fulton	St
Isabella	St
Ishmeal	St
Ithaca	St
Ivy Heath	Ln
Ivyridge	Rd
J L Reaux	St
J P Morgan Chase Backup Ccc  1010 Witte	Rd
J w Peavy	Dr
Jack	St
Jackson	
Jackson	St
Jackson Hill	St
Jackson Middle School  5100 Polk	St
Jackwood	St
Jacquelyn	Dr
James	Pl
James	St
James Franklin	St
James River	Ln
Jan Kelly	Ln
Janak	Dr
Jane Long Middle School  6501 Bellaire	Blvd
Janisch	Rd
Japonica	St
Jason	Dr
Jason	St
Jason's School of Rock  12655 Woodforest	Blvd
Jay	St
Jeanetta	St
Jefferson	
Jefferson	Ave
Jefferson	St
Jefferson-Pierce	
Jennetta	St
Jensen	Dr
Jerusalem Temple Free Church of God in Christ  8145 Howton	St
Jessamine	St
Jester	St
Jewel	St
Jewett	St
JF Southwest Heart Clinic  9888 Bellaire	Blvd
Jim	St
Jim W	St
Johanna	Dr
John	St
John Alber	Rd
John F Kennedy	Blvd
John F Kennedy Service	
John F Kennedy Service	Rd
John Knox Presbyterian Church  2525 Gessner	Dr
Johnny Nash Indoor Arena  6200 Willardville	Rd
Johnson	St
Johnson Space Center Heliport	
Johnston	St
Johnston Middle School  10410 Manhattan	Dr
Joplin	St
Joseph	
Josephine Houston Elementary School  5409 Ponciana	Dr
Joslin Diabetes Center Affiliate at Cypress Fairbanks Medical Center Hospital  11302 Fallbrook	Dr
Joyce	St
Judiway	St
Julia	St
Junell	St
Juniper	
Junius	St
Jutland	Rd
Kane	St
Kansas	St
Karalis	Rd
Kashmere	St
Kassarine	Pass
Katherine	Ct
Katherine	St
Katy	Fwy
Katy	Rd
Katy	St
Katy Flewellen	Rd
Katy Freeway Service	Rd
Katy Frwy Service	Dr
Katy Hockley	Rd
Katy Hockley Cut Off	Rd
Katy-Gaston	Rd
Kay	
Keegan	Rd
Keegans Ridge	Rd
Keegans Ridge Way	Dr
Keene	St
Keene Mill	Ct
Keene Mill	Dr
Keith-Wiess Geological Laboratories	
Kelburn	Dr
Keller	St
Kellett	St
Kelley	Creek
Kelley	St
Kelling	St
Kellogg	St
Kelly	Dr
Kelly	Ln
Kelly	Rd
Kelly	St
Kelly Brook	TR
Kelly Hill	Ct
Kelly Lake	Tr
Kemp Forest	Dr
Kempridge	St
Kempwood	Dr
Kenilwood	Dr
Kenilworth	St
Kennedy	St
Kennedy Heights	Blvd
Kennedy Oaks	St
Kenswick	Dr
Kenton	St
Kentshire	Dr
Kentucky	St
Kernel	St
Kerrwood	Ln
Kettering	Dr
Kevin	Ln
Kevin Williamson Piano School	
Key	St
Key Middle School  4000 Kelley	St
Keyport	Ln
Keystone	St
Kids Arena Academy Day Care  8373 Creekbend	Dr
Kids R Us Academy  9385 Richmond	Ave
Kimberley	Ln
KinderCare Learning Center  14614 Wallisville	Rd
KinderCare Learning Center  19823 Younglake	Blvd
KinderCare Learning Center  2349 FM 1960	Rd
KinderCare Learning Center  2526 Walnut	Bend
KinderCare Learning Center  937 Bunker	Hill
Kindred Hospital-Houston  6441 Main	St
King	
King	St
King Air Airport	
Kinghurst	St
Kings	Ct
Kings	Row
Kings	Trail
Kings	Way
Kings Crossing	Dr
Kings Gate	Cir
Kings Grove	Dr
Kings Mountain	Dr
Kings Ridge	Rd
Kings Walk	Ln
Kingsflower	Cir
Kingspoint	Rd
Kingsride	Ln
Kingston	Dr
Kingsway	Dr
Kingswood	Ln
Kingwood	
Kingwood	Dr
Kingwood Church of Christ  2901 Woodland Hills	Dr
Kingwood Park High School  4015 Woodland Hills	Dr
Kipling	St
Kipp Houston  10711 Kipp	Way
Kipper Mease Sports Complex  10700 Red Bluff	Rd
Kirby	Dr
Kirby	Park
Kirby Jr High School	
Kirby Middle School	
Kirby Middle School  9709 Mesa	Dr
Kirk	St
Kirkholm	Dr
Kirkpatrick	Blvd
Kirkwood	
Kirkwood	Dr
Kirkwood	Rd
Kirkwood	St
Kirkwood Church  12001 Moonmist	Dr
Kirkwood Dance Studio  10906 Beamer	Rd
Kirkwood South Christian Church  10811 Kirkfair	Dr
Kittridge	St
Kitty Brook	Dr
Kleckley	Dr
Knight	
Knight	Rd
Knob Mountain	Trail
Knoboak	Dr
Knottynold	Ln
Knox	St
Knoxville	St
Kopman	Dr
Kress	St
Kress Lyons	Park
Kristin Lee	Ln
Krueger	Rd
Kurland	Dr
Kuykendahl	Rd
Kyle Chapman Pony League  6400 Bissonnet	St
L	St
L B Houston Tennis  11225 Luna	Rd
L Medical Center IMRT LLC  9150 Main	St
La Branch	St
La Concha	Ln
La Fonda	Dr
La Mesa	Dr
La Porte	Fwy
La Porte	Rd
La Porte Freeway Frontage	
La Porte Freeway Service	Rd
La Quinta Inn Houston La Porte  1105 Hwy 146	
La Salette	St
Labco	St
Lake	Glen
Lake	Ln
Lake	St
Lake	Village
Lake Canyon	Ct
Lake Conroe	Dr
Lake Conroe Hills	Dr
Lake End	Dr
Lake Forest	Blvd
Lake Forest	Cir
Lake Front	Ct
Lake Harbor	Way
Lake Harbor Way	Cir
Lake Hills	Dr
Lake Houston	
Lake Houston	Park
Lake Houston	Pkwy
Lake Houston Parway	
Lake Kingwood	Trail
Lake Lodge	Dr
Lake of	Pkwy
Lake Park	St
Lake Pines	Dr
Lake Point	Dr
Lake Ridge	Ct
Lake View	Dr
Lake Village	Dr
Lakecrest	Dr
Lakefield	Dr
Lakefront	Ct
Lakefront	Dr
Lakehurst	Dr
Lakes at 610	Dr
Lakes of	Pkwy
Lakeshore	Way
Lakeshore Bend	Dr
Lakeshore Way	Cove
Lakeshore Way	Ct
Lakeside Estates	Dr
Lakeview	Dr
Lakewood	
Lamar	
Lamar	St
Lamar Fleming	St
Lamar Fleming  Jr Bldg	
Lamar Jr Sr High  930 E Stadium	Dr
Lamont	Cir
Lamonte	Ln
Lamonte Park Townhomes  3737 Watonga	Blvd
Lana	Ln
Lana Lee	Ct
Lancaster	St
Lancaster Hotel  701 Texas	Ave
Lancaster Pl	Dr
Lancaster Walk	Dr
Landor	St
Lands End	Cir
Lands End	Dr
Lands Walk	Dr
Landsdowne	Dr
Lane	St
Lang	Rd
Langdon	Ln
Langfield	Ct
Langfield	Rd
Langham	Creek
Langham	Dr
Langham	Way
Langham Creek College  6516 Alisa	Ln
Langham Creek Estates	Dr
Langham Creek High School	
Langham Creek High School  17610 FM 529	Rd
Langham Way	Dr
Langley	Rd
Langtry	Ln
Langtry	St
Language USA Inc  440 Louisiana	St
Langwick	Dr
Lanham	Ln
Lansdale	Dr
Lansdale	Park
Lantern Point	Dr
Larchwood	Dr
Larimer	St
Lark	Ln
Larkin	St
Larkspur	St
Larkstone	St
Larkwood	Dr
Larson	St
Lasalle	Ln
Laser Quest  6560 Cypress Creek	Pkwy
Lathrop	St
Laura	
Laura	Cir
Laura Anne	Dr
Laura Koppe	Rd
Laura Koppe Church Of Christ  6601 Laura Koppe	Rd
Laura Lee	Ln
Laura Mae Hill School	
Laura Way	Dr
Laurel Creek	Way
Laurel Rose	Ln
Laurel Springs	Ln
Laurel Timbers	Dr
Laurentide	St
Lavaca	St
Lavender	
Lavender	St
Laverne	St
Law Office of Michael Eddings  1300 N  Sam Houston	Fwy
Lawler	Ridge
Lawler	St
Lawndale	Plaza
Lawndale	St
Lawndale Art Center  4912 Main	St
Lawnridge	St
Lawrence	
Lawrence	Dr
Lawrence	Park
Lawrence	St
Lawrence Eckert Intermediate  1430 Aldine Meadows	Rd
Lawson	St
Lazy Hollow	Dr
Lazy Ln	Blvd
Lazy Oaks	St
Lazy Spring	Dr
Le Green	St
Lea	St
Lea Valley	Dr
Leader	St
Leaders Crossing	Dr
Leaf	Dr
Leamont	Dr
Leander	St
Leather Market	St
Leawood	Blvd
Leawood	Ct
Leben	St
Ledbetter	St
Ledge	
Ledge	St
Lee	Ln
Lee	Rd
Lee	St
Lee Elementary School  12900 W Little York	Rd
Lee Land	Dr
Leeland	Ave
Leeland	St
Legion	St
Lehall	St
Leicester	Ln
Leitrim	Way
Lelay	Cir
Lelia	St
Lemac	Dr
Lenore	St
Lenox	St
Leonora	St
Lera	St
Leslie	St
Lettie	Ave
Lettie	St
Ley	Rd
Liberty	
Liberty	Ln
Liberty	Rd
Liberty	St
Life Public Charter School  5500 El Camino Del Rey	St
Lift Crane Heliport	
Lila	St
Lillian	St
Limestone	St
Lindale	St
Lindale Assembly of God Church  500 North Loop 610	
Lindale Baptist Church  6615 Irvington	Blvd
Lindale Church of Christ  6502 Enid	St
Lindbergh	St
Linden	St
Linder	St
Linder Learning Land  14600 Gladebrook	Dr
Lindsay	St
Link	Ct
Link	Rd
Link Lee	
Link Valley	Dr
Link-	Loop
Linkwood	Dr
Linkwood	Park
Linkwood Skatepark	
Little Barley	Ct
Little York	
Little York	Rd
Little York Baptist Church  609 Little York	Rd
Little York Hollow	Ln
Little York Pr 1	Dr
Little York Pr 2	Dr
Little York Volunteer Fire Dept  10410 Airline	Dr
Live Oak	St
Loch Langham	Dr
Locke	Ln
Lockhart	
Locksley	Rd
Locksley Trace	Ct
Lockwood	
Lockwood	Dr
Log Hollow	Dr
Loma Vista	St
Lomax	St
Lonallen	St
Lone Star Executive Airport	
Lone Willow	Ln
Long	Dr
Long	Rd
Long Branch	Ln
Long Creek	Ln
Long Gate	Dr
Long Glen	Dr
Long Leaf	Dr
Long Meadow	Dr
Long Meadow	St
Long Oak	Dr
Long Point	Rd
Long Prairie	Dr
Longridge	Dr
Longview	St
Lonquist Field Services LLC  1001 Mckinney	St
Loop	
Loop	Fwy
Loop	Rd
Loop E	Fwy
Loop E Service	Rd
Loop East Service	Rd
Loop Fwy Srv	Rd
Loop N	Fwy
Loop N Service	Rd
Loop S	Fwy
Loop W	Fwy
Loop West Freeway Service	Rd
Loper	St
Lorraine	St
Louise	St
Louisiana	St
Louisiana Department-Natural Rsrce  5177 Richmond	Ave
Louisville	St
Lovejoy	St
Lovers	Ln
Lovett	Blvd
Lovett College Masters House	
Lovett Elementary School  8814 S Rice	Ave
Lovett Hall	
Lovett Lot	
Lovett School  8814 S Rice	Ave
Lozier	St
Lubbock	St
Lubbock School	
Luca	St
Lucille	St
Lucky	St
Ludington	Dr
Lugary	Dr
Lumpkin	Rd
Luna	St
Luzon	St
Lydia	St
Lyerly	St
Lymbar	Dr
Lyndhurst	Dr
Lyndon B  Johnson Space Center  2101 Nasa	Pkwy
Lynette	St
Lynn	
Lynn	St
Lynnfield	St
Lyons	Alley
Lyons	Ave
Lyons Clinic  5602 Lyons	Ave
Lyons Elementary School  800 Roxella	St
Lyons Pharmacy  5602 Lyons	Ave
M D Anderson Library  1 Main	St
Mabry Mill	Rd
Mac Gregor	Way
Macario Garcia Elementary School  9550 Aldine Westfield	Rd
MacArthur Elementary School-Houston  5909 England	St
Mace	Rd
Macgregor	Dr
MacGregor	Way
Mack	
Madera	Rd
Mae	Dr
Maggie	St
Magnolia	
Magnolia	Canyon
Magnolia	Cir
Magnolia	Spring
Magnolia	St
Magnolia	View
Magnolia	Way
Magnolia Lake	Ln
Magnolia Shadows	Ln
Main	
Main	Hwy
Main	St
Majestic	St
Mall	
Mallard	Dr
Mallard	St
Mallard	Way
Mallard Lake	Ln
Mallard Landing	Ct
Mallard Stream	Ct
Mallard Stream	St
Mallow	St
Maltby	St
Man O' War	Ct
Man O' War	Ln
Manchester	St
Manchester Baptist Church  9301 Manchester	St
Mandell	St
Mango	St
Mangum	Rd
Mann Eye Insitute and Laser Center  5115 Main	St
Mansfield	St
Mansfield Glen	Ct
Mansfield Point	Ln
Maple	Dr
Maple	St
Maple Hill	Dr
Maple Hill	Trail
Maple Leaf	St
Maple Tree	Dr
Maple Walk	Dr
Mapleridge	St
Marconi	St
Mardale	Dr
Marilee	Ln
Marina Bay	Dr
Marinette	Dr
Marinwood	Dr
Marion	St
Marjorie	St
Market	St
Market Street	Rd
Marleen	St
Marlene	St
Maroby	St
Martial Arts USA Inc  17121 W	Rd
Martin	St
Martin Luther King	Dr
Martin Luther King Early Child  3930 W Fuqua	St
Martin Luther King Humanities	Center
Martindale	Rd
Mary Bates	Blvd
Mary Moody Hall  S Shepherd	Dr
Mason	St
Master Lee's Martial Arts Ctr  9883 Long Point	Rd
Mathews	St
Mathis	St
Mathis Church	Rd
Maury	St
Maux	Dr
Maxey	Park
Maxey	Rd
Maxie	St
Maxroy	St
Mayberry	St
Mayde Creek Elementary School  2698 Greenhouse	Rd
Mayfield	Rd
Mayflower	
Mayflower	St
Maywood	St
Mc Alpine	St
Mc Kinney	
Mcavoy	Dr
McCarty	Dr
McCarty	Rd
McCarty	St
McDaniel	St
McDuffie	St
Mcgallion	Rd
McGee	Ln
McGowan	Ln
Mcgowan	St
McGowen	Ln
McGowen	St
Mchenry	St
McIlhenny	St
McIntosh	St
McKaughan	Rd
McKay	Blvd
McKay	Bridge
McKee	St
McKinney	
McKinney	Dr
McKinney	St
McKinney Creek	Ln
Mckinney Park	Ln
McKnight	St
Mcnair	St
McNee	Rd
Mcneil	St
Meadow	St
Meadow Butte	Dr
Meadow Creek	Ln
Meadow Edge	Ln
Meadow Gardens	Dr
Meadow Glen	Dr
Meadow Green	Dr
Meadow Heights	Dr
Meadow Lea	Dr
Meadow Park	Dr
Meadow Pines	Dr
Meadow Point	Ct
Meadow Terrace	Dr
Meadowfair	St
Meadowfern	Dr
Meadowglen	Cove
Meadowglen	Crest
Meadowglen	Dr
Meadowglen	Ln
Meadowglen Chase	
Meadowland	Dr
Meadowlink	St
Melanie	Ln
Melanie	St
Melanite	St
Melbourne	St
Melwood	St
Memorial	Ct
Memorial	Dr
Memorial	Heights
Memorial	Way
Memorial Brook	Blvd
Memorial City	Way
Memorial Greens	Dr
Memorial Heights	Dr
Memorial Hermann  9401 Southwest	Fwy
Memorial Hermann Breast center  Hermann Professional Bldg	
Memorial Hermann Healthcare  7737 SW	Fwy
Memorial Hermann Katy Hospital  23900 Katy	Fwy
Memorial Hospital on	Dr
Memorial Loop	Dr
Memorial Mews	St
Memorial Park Conservancy Inc  6501 1/2 Memorial	Dr
Memorial Parkway Elementary School  21603 Park Tree	Ln
Memorial Parkway Jr High  21203 Highland Knolls	Dr
Memorial Parkway Jr High School	
Mercury	Dr
Mercury Cove	Ct
Merrimac	St
Merriwood	Ln
Mesa	Dr
Mesa	Mountain
Mesa Brook	Ln
Mesa Gardens	Dr
Mesa Grill  1971 W Gray	St
Mesa Ridge	Rd
Mesa Terrace	Dr
Mesa Verde	Dr
Mesa Vista	Dr
Meyer Forest	Dr
Michael	
Michael	Cir
Michael	Dr
Michael E  Debakey VA Medical Center  2002 Holcombe	Blvd
Michael J  Cemo Hall	
Michael Kennedy Elementary School  10200 Huntington Pl	Dr
Michael Mann  5115 Main	St
Michaux	St
Mickey Leland Memorial Park  3701 Cavalcade	St
Mid-Pines	Dr
Middle	St
Middle Creek	Dr
Middlebrook	Dr
Middlecreek	St
Midfield	Dr
Midnight	Ln
Mighty Elm	Ct
Mikado	St
Milam	
Milam	St
Milam School  1100 Roy	St
Milan	Dr
Milan	Estates
Milby	
Milby	St
Miles	St
Miley	St
Milford	St
Miller	St
Millport	St
Mills	Rd
Mills	St
Mills Bend	St
Mills Branch	Dr
Mills Branch	Rd
Mills Trace	Ct
Millville	Dr
Milwaukee	St
Milwee	St
Minden	St
Minetta	St
Minnesota	St
Mississippi	St
Missouri	St
Mistral Early Childhood Ed Center  6203 Jessamine	St
Misty Heath	Ln
Misty Lea	Ln
Misty Meadow	Ln
Misty Vale	Ln
Mitre Peak	Ln
Mobile Home	Park
Mohawk	St
Moline	St
Mona Lee	Ln
Mona Shah  MD  Texas Children's Hematology Center  6701 Fannin Street  Suite	
Monkey Joe's  12523 Westheimer	Rd
Monkey Joe's  511A S Mason	Rd
Monrad	Dr
Monroe	
Monroe	Rd
Monroe	St
Monroe Pr 1	Dr
Monroe Pr 4	Dr
Monroe Pr 5	Dr
Monroe Pr 7	Dr
Montgomery	Rd
Montrose	
Montrose	Blvd
Montrose School	
Monumento de San Jacinto  510 Bering	Dr
Moody	Park
Moody	St
Moody Pines	Ct
Moody Towers	
Moonmist	Dr
Moorberry	Ln
Moore	St
Moran Center Parking Facility	
Morgan	
Morgan	Creek
Morgan	Dr
Morgan	St
Morgan Ranch Trial	
Morgan University Green Apartments  16512 Bramble	Way
Morganfair	Ln
Moritz	Dr
Morley	St
Morningside	
Morningside	Dr
Morris	
Morse	St
Mosley	Ct
Mosley	Rd
Moss Rose	St
Mount	St
Mountain	Green
Mountain Cliff	Ln
Mountain Green	Trail
Mountain Heights	Dr
Mountain Lake	Dr
Mountain Meadows	Dr
Mountain Ridge	Rd
Mountain Rose	Ln
Mountain View	Dr
Mountfield	Dr
Mt Andrew	Dr
Mt Calvary Lutheran Church  1055 W Tidwell	Rd
Mt Carmel	St
Mt Carmel Baptist Church	
Mt Carmel Church of God in Christ  7438 Emma Lou	St
Mt Houston	Rd
Mt Houston Baptist Church  5805 Mt Houston	Rd
Mt Houston Pharmacy  11703 Eastex	Fwy
Mt Houston School	
Mt Olive Church of God  9222 Wilcrest	Dr
Mt Pleasant	Cir
Mt Pleasant	St
Mt Vernon United Methodist Church  1501 Jensen	Dr
Mt Zion Apostolic Baptized Church  7713 Wileyvale	Rd
Mulberry	St
Mullins	Dr
Mullins	Ln
Mulvey	St
Munger	St
Munn	St
Murphy	
Murray	Rd
Murray Bay	St
Murray Brook	Dr
Murworth	Dr
Mustang	
Mustang	Alley
Mustang	Field
Mustang	Ln
Mustang	Trail
Mustang Mountain	Ct
Mustang Ridge	Rd
Mykawa	Rd
Myrtle	St
Nagle	
Nagle	St
Nairn	St
Nance	St
Naomi	St
Napoleon	St
Narcissus	St
NASA	Road
Nashville	St
Nat Turner	Dr
National	St
Navigation	Blvd
Nedwald	St
Neff	St
Nelda	Rd
Nellie Gail Trail	Ln
Nenana	Dr
Nett	St
Neuens	Rd
Neuhaus	Ave
New Beginnings Church of Greenspoint  141 Greens	Rd
New Green	Ct
New Haven	Dr
New Life Church On Northpark  4032 Northpark	Dr
New Orleans	St
New York	St
Newberry	St
Newcastle	Dr
Newcastle	St
Newhoff	St
Newland Crest	Dr
Newpark	Dr
Newport	Blvd
Newport	Ln
Newport	St
Newquay	St
Neyland	St
Niagara	St
Nichole Woods	Dr
Nichols	St
Nicholson	St
Nickerson	Ln
Night Light Pediatric Urgent Care  15551 Southwest	Fwy
Nimitz	
Nimitz	St
Nina Lee	Ln
Noah	St
Noble	St
Noble Cypress	Ct
Noble Lakes	Ln
Noble Meadow	Ln
Noble Oak	Ct
Noble Oak	Trail
Noble Oak	Way
Noble Pine	Dr
Noble Springs	Rd
Noblecrest	Dr
Nolda	St
Nordic	Dr
Nordling	Rd
Norfolk	St
Norhill	Blvd
Normandy	St
Normandy	Way
Normandy Crossing	Dr
Normandy Crossing Elementary School  12500 Normandy Crossing	Dr
Normandy Forest	Ct
North	
North	Ave
North	Blvd
North	Fwy
North	Ln
North	Loop
North	St
North Hill	Dr
North Sam Houston	Pkwy
Northborough	Dr
Northbrook	Dr
Northchase	Dr
Northcourt	Rd
Northcrest	Blvd
Northcrest	Ct
Northcrest	Dr
Northcrest	Trail
Northdale	St
Northern	Dr
Northern	St
Northern Oak	St
Northern Star	Dr
Northlake	Dr
Northline	Dr
Northpark	Dr
Northpark Central	Dr
Northpoint	Dr
Northport	Dr
Northridge Park	Dr
Northrup	Dr
Northshore	Park
Northumb	Rd
Northwest All-Star Gymnastics  5701 Bingle	Rd
Northwest Church of Christ  6720 W Tidwell	Rd
Northwood	St
Northwood Forest	Dr
Norwood	St
Norwood Trails	Dr
Nottingham Oaks	Trail
Nuben	St
Null Middle School  12117 Garrett	Rd
Nyack	Dr
Nyssa	St
O Donnell	Dr
O S T	Dr
Oak	Ct
Oak	Dr
Oak	Ln
Oak	Mews
Oak	Pl
Oak	St
Oak Acres	Dr
Oak Arbor	Dr
Oak Bay	Dr
Oak Creek	Dr
Oak Creek	St
Oak Forest	Dr
Oak Forest Baptist Church  1700 W 43rd	St
Oak Knoll	Ln
Oak Limb	Dr
Oak Link	Ct
Oak Meadows	St
Oak Meadows Church of God of Prophecy  6105 Allendale	Rd
Oak Pkwy	Dr
Oak Shores	Dr
Oak Stand	Ct
Oak Timbers	Dr
Oak Tree	
Oak Tree	Dr
Oak Valley	Dr
Oak W	Dr
Oakcliff	St
Oakdale	St
Oakham	St
Oakhurst	St
Oakhurst Green	Dr
Oaks	Dr
Oaks	Pl
Oakside	Dr
Oaktree	St
Oasis View	Ln
Oates	Ln
Oates	Rd
Oates Elementary School	
Oates School  10044 Wallisville	Rd
Oats	St
Ocean	Dr
Ocean Laurel	Ln
Ocean Point	Dr
Oceanside	Dr
Oceanview	St
Ocee	St
Oddo	St
Office City	Dr
Ojeman	
Ojeman	Pl
Ojeman	Rd
Okanella	St
Olathe	St
Old	Highway
Old Airline	Rd
Old Chatham	Ln
Old Clinton	Rd
Old Creek	Rd
Old Fairbanks	Rd
Old Galveston	Rd
Old Genoa Red Bluff	Rd
Old Greenhouse	Rd
Old Houston	Hwy
Old Houston	Rd
Old Humble	Rd
Old Katy	Rd
Old Ledge	Ln
Old Main Street Loop	Rd
Old Meadow	Ln
Old North Belt	Dr
Old Spanish	Trail
Old Telephone	Rd
Old US	Highway
Old Washington	Rd
Old Yale	St
Olney Oak	Dr
Olympia	Dr
Omeara	Dr
One Westchase Center Parking Garage  10777 Westheimer	Rd
Oneil	St
Orange	St
Orange Grove	Dr
Orange Leaf	Ct
Orchard Blossom	Way
Orchid	St
Orem	Dr
Oriole	
Oriole	St
Orlando	St
Orleans	St
Ormandy	St
Orr	St
Osby	Dr
OSHA Training Pros Houston Texas  1302 Waugh	Dr
Osprey	Dr
OST Baptist Church  4219 Banner	Dr
Overbrook	Dr
Overbrook	Ln
Overcross	Dr
Oxford	Ct
Oxford	St
Oxford Glen	Ln
Oxford Grove	Dr
Oxford Oak	St
Oxford Park	Dr
Oxford Point	Ln
P M Cy Fair Development LP  11307 FM 1960	Rd
Pacific	
Page	Ln
Pagewood	Ln
Paintbrush Ledge	Ln
Palestine	St
Palestine Cove	Ln
Palm	Vista
Palm Grass	Ct
Palm Lake	Dr
Palmetto	
Palmetto	Ln
Palmetto	St
Palmsprings	Dr
Pampa	St
Panair	St
Panama	St
Panay	Dr
Panay Creek	Dr
Panay Park	Dr
Panay Village	Cir
Panay Village	Dr
Pannell	St
Parana	Ct
Parana	Dr
Park	
Park	Ave
Park	Blvd
Park	Ct
Park	Dr
Park	Ln
Park	Manor
Park	Plaza
Park	Row
Park	St
Park	Terrace
Park 10	Blvd
Park 2	Dr
Park At Beverly	Hills
Park At Beverly	Hls
Park Bend	Dr
Park Briar	Dr
Park Brook	Dr
Park Center	Ct
Park Center	Dr
Park Center	Way
Park Centre	Ct
Park Cir	Dr
Park Creek	Ct
Park Creek	Dr
Park Fuqua	Dr
Park Green	Dr
Park Green	Way
Park Grove	Dr
Park Harbor	Ct
Park Harbor	Dr
Park Harbor Estates	Dr
Park Haven	Dr
Park Heath	Ln
Park Hollow	Ct
Park Key	Cir
Park Knoll	Ln
Park Line	Dr
Park Manor	Dr
Park Manor	St
Park Meadow	Dr
Park Meadows	Dr
Park Memorial Baptist Church  123 S 75th	St
Park Pl	Blvd
Park Pl	Dr
Park Plaza	Dr
Park Ridge	Dr
Park Row	Blvd
Park Row	Dr
Park Trail	Dr
Park Trail	Vista
Park View	Ct
Park View	Dr
Park Village	Dr
Park W	Dr
Park Way	Dr
Park Westheimer	Blvd
Park Westheimer	Rd
Parkcrest	Dr
Parker	Ct
Parker	Rd
Parker	St
Parker Elementary School  10626 Atwell	Dr
Parker J C  5419 Bennington	St
Parker JL  6201 Hirsch	Rd
Parker Road Pet Resort Cottages and Day Spa  6730 Airline Dr  Suite	
Parker School  10626 Atwell	Dr
Parkette	Dr
Parkfront	Dr
Parkhill	St
Parkline	
Parkridge Glen	Dr
Parkstone	Dr
Parkway	Ct
Parkway	Dr
Parkway	Pl
Parkway Fellowship  13413 Briar Forest	Dr
Parkway Plaza	Dr
Pasadena	Fwy
Pasadena	St
Pasadena Boulevard Iglesia De Crist  7524 Corpus Christi	St
Paschall	St
Path Green	Dr
Patricia	Ln
Patterson	Rd
Patterson	St
Patti	Ct
Patti Ln	Ct
Patti Lynn	Ln
Patton	St
Paul Quinn	St
Peach Blossom	St
Peach Creek	Dr
Peach Tree	Ct
Peach Tree	St
Peachtree	St
Peacock	
Pear	St
Pear Creek	Cir
Pear Glen	Ct
Pear Meadow	Ln
Pear Oak	Dr
Pearce Industries Heliport	
Pearl	
Pearl	St
Pearl Hall	
Pearland	Pkwy
Peas In A Pod Child Care   Child Care Houston  6038 Bassetdale	Ln
Pease	St
Pecan	St
Pecan Knoll	Dr
Pecan Villas	Dr
Pech	Rd
Pecore	
Pecore	St
Peden	St
Peerless	
Peerless	St
Pelsey	St
Pembrook	St
Penelope	Dr
Penn	St
Pensgate	St
Pentecostals-Hiram Clarke Church  5330 W Orem	Dr
Peoria	St
Perkins	
Perry	Ave
Perry	Rd
Perry	St
Perry Cemetery	
Persa	St
Pershing	St
Pershing Middle School  3838 Blue Bonnet	Blvd
Perthshire	Rd
Peters	Rd
Petty	St
Philip Guthrie Hoffman Hall	
Phillips	
Phillips	Ln
Phillips	St
Philmont	Dr
Pickering	St
Pickfair	St
Picnic	Ln
Pierce	
Pierce	St
Pin Oak	Park
Pin Oak Creek	Ln
Pinckney	St
Pine	
Pine	St
Pine Bend	Dr
Pine Blossom	Trail
Pine Branch	Dr
Pine Garden	Dr
Pine Lake	Dr
Pine Lake	Trail
Pine Manor College  Ste 233  9219 Katy	Fwy
Pine Valley	Dr
Pine Village	Dr
Pinehurst	Ct
Pineloch	Dr
Pineloch Medical Clinic  1051 Pineloch	Dr
Pinemont	Dr
Pinemont	Park
Pines	Dr
Pineview	Dr
Pipers View	Dr
Piping Rock	Dr
Piping Rock	Ln
Pitner	Rd
Plainfield	St
Plainview	St
Plaza Verde	Dr
Pleasantville	Dr
Pleasantville	Park
Pleasantville School  1431 Gellhorn	Dr
Plum Creek	Ln
Plum Hollow	Dr
Plumpoint	Dr
Podium Taekwondo  2655 Gessner	Dr
Point Park	Dr
Police Station Number 2 Heliport	
Polk	Ave
Polk	Ct
Polk	St
Pompano	Ln
Pompton	Dr
Poppy	St
Poppy Trails	Ln
Port	
Port	Rd
Port	St
Port Branch	Dr
Port Houston	
Port of Houston Authority  111 East	Loop
Portal	Dr
Portsmouth	Ave
Portsmouth	St
Portwall	St
Post	St
Post Oak	Blvd
Post Oak	Cir
Post Oak	Dr
Post Oak	Hill
Post Oak	Ln
Post Oak	Pkwy
Post Oak	Rd
Post Oak Grill  1415 S Post Oak	Ln
Post Oak Park	Dr
Post Oak Park  Post Oak Park	Dr
Post Oak Pl	Dr
Prairie	
Prairie	St
Prairie Brook	Ct
Prairie Grove	Dr
Prairie Knoll	Ct
Prairie Mark	Ln
Prairie Ridge	Rd
Prairie View	Dr
Pressler	St
Preston	St
Prestwood	Dr
Pride Committee of Houston Inc  401 Branard	St
Priest	Dr
Primrose	St
Prince	St
Providence	
Providence	St
Purple Sage	Rd
Quail Briar	Dr
Quail Croft	Dr
Queens Way	Cir
Quenby	St
Quitman	Ct
Quitman	St
R V Mayfield	Dr
Radcliffe	St
Radio	Rd
Raider	Cir
Rain Lily	Ln
Ralph Waldo Emerson School	
Ramada	Dr
Ramp Creek	Ln
Rampart	St
Ranchester	Dr
Rand	St
Rankin	Rd
Rannie	Rd
Raymondville	Rd
Rayson	Rd
Rd	
Reamer	St
Red Alder	Cir
Red Castle	Ln
Red Man	Rd
Red Mesa	Dr
Red Oak	
Red Ripple	Rd
Redan	St
Redbud	St
Redbud Brook	Trail
Redford	St
Redland Woods	Dr
Redondo	Dr
Redstone  Saturn	Ln
Redwood	
Redwood	St
Reed	Rd
Reeves	St
Regency	Dr
Regency	Ln
Regency Green	Dr
Regency Square	Blvd
Regency Square	Ct
Regency Villa	Dr
Regg	Dr
Rehabilitation Services Division  444 Holderrieth	Blvd
Reid	
Reid	St
Reims	Rd
Reinerman	St
Remington Valley	Dr
Renshaw	St
Rentur	Dr
Renwick	Dr
Representative Kevin Bailey  403 Sulky Trail	St
Representative Michael Mc Caul  1550 Foxlake	Dr
Residence Inn Houston Intercontinental Airport at Greenspoint  655 North Sam Houston	Pkwy
Residence Inn Houston-West University  2939 Westpark	Dr
Restridge	Dr
Retta	St
Reveille	
Reveille	Park
Reveille	St
Reveille Swimming Pool  7700 Oak Vista	St
Revere	
Reverend B J Lewis	Dr
Rhobell	St
Rhode Island	St
Ribbon Wood	St
Rice	Ave
Rice	Blvd
Rice Owls Ticket Information  6100 Main	St
Rice School  7550 Seuss	Dr
Rice Stadium  6100 Main	St
Rice University  6100 Main	St
Rice University  English as a Second Language Program (ESL)  6100 Main	St
Rice University Art Gallery  6100 Main	St
Rice University Gate #13 (Greenbriar Visitor Parking Lot)  6100 Main	St
Riceville School	Rd
Richcrest	Dr
Richey	
Richey	Rd
Richey	St
Richland	Dr
Richmond	Ave
Richmond Gaines	Rd
Rick Schneider	Dr
Rick Schneider Middle School  8420 Easthaven	Blvd
Ridge	Dr
Ridge	Rd
Ridge Creek	Cir
Ridge Creek	Dr
Ridge Pine	Dr
Ridgecreek	Cir
Ridgecreek	Dr
Ridgecrest	Dr
Ridgecrest Elementary School	
Ridgecroft	Rd
Ridgerod	Ln
Ridgevan	St
Riesner	St
Riggs	Rd
Riner	St
Ringold	St
Ripplebrook	Dr
Riptide	Dr
Rittenhouse	Rd
Rittenhouse	St
Rittenhouse Baptist Church  513 W Rittenhouse	Rd
Rittenhouse Village	Ct
Rittenhouse Village	Rd
River	Dr
River Falls	Dr
River Laurel	Dr
River Oaks School of Dancing  2621 S Shepherd	Dr
River Sage	Dr
River Valley	Dr
Riverview Way	Dr
Roark	Rd
Robbie	St
Robert James	Ln
Roberts	St
Robertson	
Robertson	St
Robertson Science Hall	
Robertson Stadium  3875 Holman	St
Robertson Stadium-University of Houston  3875 Holman	St
Robindell	Dr
Robinhood	St
Robita	St
Robmore	St
Rockcrest	
Rockford	Dr
Rockhill	St
Rockleigh	Pl
Rockwell	Blvd
Rocky Creek	Rd
Rodney	
Rodney	St
Roe	Dr
Rogerdale	Rd
Rogers	St
Roland	Rd
Roland	St
Roland Canyon	Dr
Roland Trunkline	
Rolland	
Roma	St
Ronda	Ln
Rookin	St
Roos	Rd
Roosevelt	
Roosevelt	St
Roosevelt Alexander Elementary  6161 S Fry	Rd
Roper	St
Rosa Allen	St
Rosalie	St
Rosamond	St
Rose Arbor	Ln
Rose Bay	Dr
Rosedale	St
Rosefield	Dr
Roseglen Meadow	Ln
Rosehaven	Dr
Roseland	St
Roselane	St
Rosie	St
Ross	
Ross	Rd
Ross Andrew	Rd
Ross Sterling	Ave
Rosslyn	Rd
Rosslyn Landing	Ln
Rosstown	Way
Roswell	St
Rothermel	Rd
Rothwell	St
Roundtree	St
Rouse	St
Rowan	Ln
Rowe	Ln
Rowlett	Rd
Roxburgh	Dr
Roxbury	Rd
Roxella	St
Roy	Cir
Roy	St
Roy Bean	Dr
Roy G  Cullen Bldg	
Royal	Crest
Royal	Dr
Royal	Walk
Royal Chase	Dr
Royal Cir	Dr
Royal Creek	Trail
Royal Gardens	Dr
Royal Glen	Dr
Royal Hill	Dr
Royal Knoll	Ct
Royal Oaks	Crossing
Royal Oaks Country Club  2910 Royal Oaks Club	Dr
Royal Trail	Dr
Rue	St
Ruffino	Rd
Ruiz	St
Ruland	Rd
Runnels	
Runnels	St
Rushbrook	Dr
Rushcreek	Dr
Rusk	St
Russell	
Russell	Dr
Russell	St
Russell Palmer	Rd
Rustic	St
Rustic Bridge	Ln
Rustic Meadow	Ct
Rutherford	Ln
Ruthven	St
Rutland	St
Ryson	St
Sabine	St
Sabine Brook	Way
Sabo	Rd
Sadler	St
Sage	Rd
Sage	St
Sage Aspen	Ln
Sage Gale	Dr
Sage Karon	
Sage Lee	Dr
Sage Pl	Dr
Sageberry	Dr
Sageforest	Dr
Sagepark	Ln
Sageplum	Dr
Sagetree	Dr
Sagewind	Dr
Sakowitz	St
Salford	Dr
Salina	St
Sam Houston	
Sam Houston	Cir
Sam Houston	Dr
Sam Houston	Pkwy
Sam Houston	Rd
Sam Houston	St
Sam Houston	Trail
Sam Houston Elementary School  363 Norton	St
Sam Houston Middle School  2232 Sussex	Dr
Sam Houston Monument	
Sam Houston National Forest  394 Farm to Market	
Sam Houston Park	Dr
Sam Houston Primary School	
Sam Houston Race Park Ltd  7575 North Sam Houston	Pkwy
Sam Houston School	
Sam Houston School  601 W Lewis	St
Sam Houston State University  1802	Ave
Sam Houston State University  1803	Avenue
Sam Houston Tollway	
Sam Rose	St
Sam Wilson	St
Sampson	St
Samrose	Dr
San	Cir
San Angelo	St
San Felipe	
San Felipe	Rd
San Felipe	St
San Felipe Park  Gillette	St
San Jacinto	
San Jacinto	Blvd
San Jacinto	Ct
San Jacinto	Dr
San Jacinto	St
San Jacinto College  13735 Beamer	Rd
San Jacinto College South  13735 Beamer	Rd
San Jacinto Museum  510 Bering	Dr
San Marcos	St
San Saba	St
Sand	
Sand Prairie	Ln
Sanders	
Sanders	St
Sandhill Crane	Dr
Sandle	St
Sandman	
Sandman	St
Sandpiper	Dr
Sandra	Ln
Sandra	St
Sandra Ann	Ct
Sands Point	Dr
Sands Point Cove Apartments  8600 Sands Point	Dr
Sands Point Elementary School	
Sandswept	Ln
Sandy Forks	Dr
Sanford	Rd
Sanford-Brown Institute  10500 Forum Pl	Dr
Santa Fe	
Santa Maria	St
Santa Rosa	St
Sao Paulo	St
Sapling	Way
Sarah	St
Sardis	Ln
Sauer	Alley
Sauer	St
Saulnier	St
Saunders	Rd
Savoy	Dr
Sawmill	Trail
Sawyer	St
Sawyer Heights	St
Sawyer Park Sports Bar  2412 Washington	Ave
Saxon	Dr
Sayers	St
Scanlock	St
Scarlet Tanager	Dr
Scarsdale	Blvd
Schiller	Rd
Schiller	St
Schneider	Rd
Schneider	St
School of the Good Shepherd  12705 Robert E Lee	Rd
Schools  Boone Elementary	
Schools  Fleming Middle  4910 Collingsworth	St
Schroeder	Rd
Schuler	St
Schuller	Rd
Schweikhardt	St
Scott	
Scott	St
Scott Callahan Law Offices  1177 W	Loop
Scott School  3300 Russell	St
Scott's Siu Lum Gung Fu (Kung Fu) Academy  2900 NASA	Parkway
Scottcrest	Dr
Scranton	St
Sea Island	Dr
Sea Lark	Rd
Sea Liner	Dr
Sea Meadow	Ct
Sea Shore	Dr
Sea Smoke	Ln
Seabrook	St
Seacliff	Dr
Seafoam	Rd
Seaford	Dr
Seagate	Ln
Seagler	Rd
Seagler Park	Ln
Seagler Pond	Ln
Seagler Springs	Ln
Seahorse	Dr
Sealey	St
Searle	Dr
Seaspray	Ct
Second Mt Olive Baptist Church  5214 Cavalcade	St
Seeker	St
Segrest	Dr
Sela	Ln
Selinsky	Rd
Seminar	Dr
Senford High School  23 Sunset	Blvd
Ser-Ninos Charter Elementary School	
Ser-Ninos Charter Elementary School  5815 Alder	Dr
Service	Dr
Service	Rd
Service	St
Service Center	Dr
Seventh Day Adventist Church  4318 Robertson	St
Seville	St
Sexton	St
Sgt Macario Garcia	Dr
Shadow Briar	Ln
Shadow Briar Rec Center  12130 Olympia	Dr
Shadow Oaks	Dr
Shadow Rock	Dr
Shadow Wood	Dr
Shadowbark	Dr
Shadowbriar	Dr
Shadowdale	Dr
Shady	Dr
Shady	Ln
Shady Arbor	Ln
Shady Creek	Dr
Shady Park	Dr
Sharmon	Rd
Sharon	St
Sharpcrest	St
Sharpview	Dr
Shaver	St
Shawna	Dr
Shawna	St
Shawnee	St
Shearn	St
Shearn School  9802 Stella Link	Rd
Sheffield	Blvd
Sheffield Bend	Ct
Sheffield Bend	Dr
Sheffield Congretional Seventh Day Adventist Church	
Sheffield Falls	Ct
Sheffield Knoll	Ln
Sheffield Pines	Ln
Sheffield Terrace	Dr
Sheldon Independent School District  12117 Garrett	Rd
Shelmer	Dr
Shelton	Ct
Shelton	Rd
Shelton Grove	Dr
Shepard Drive	Underpass
Shepherd	Dr
Shepherd	Tr
Shepherd Falls	Ln
Shepherd Pr 2	Dr
Shepherd Pr 3	Dr
Shepherd Pr 4	Dr
Shepherds Ridge	Dr
Sherbourne	St
Sherman	
Sherman	St
Sherwick	St
Sherwood	
Sherwood	Dr
Sherwood	Grove
Sherwood	Ln
Sherwood	Trail
Sherwood Forest	St
Sherwood Forest Glen	Ct
Sherwood Forest Glen	Dr
Sherwood Forest Montessori School  1331 Sherwood	Forest
Sherwood Hollow	Ln
Sherwood Oaks	Dr
Short	
Shoshone	Rd
Shotwell	St
Shreveport	Blvd
Sidney	
Sidney	St
Sierra	Dr
Sierra Brook	Ln
Silber	Rd
Silver Bell	Dr
Silver Bell	St
Silver Maple	Dr
Silver Sands	Cir
Silver Sands	St
Silver Stone	St
Silvercrest	St
Silverstone	
Silverstone	Dr
Silverwood	Dr
Simmons	
Simsbrook	Dr
Simsbury	St
Simsdale	St
Sisters	St
Skinner	Rd
Skippy	
Skydive Houston Airport	
Skyline	Dr
Skyline	Trail
Skyline	Vista
Skyline Arbor	
Skyline Arbor	Terrace
Skyline Village	Dr
Skyline Village	Park
Skyline Village	Trail
Skyview Green	Dr
Sl West Houston Imrt  2610 W Sam Houston	Pkwy
Sleepy Creek	Dr
Smith	
Smith	Ave
Smith	Ln
Smith	Rd
Smith	St
Smith Elementary School-Houston  4802 Chrystell	Ln
Smoke Rock	Dr
Smooth Oak	Ln
SMU / Perkins School of Theology / Houston-Galveston  3501 W Alabama	
Soaring Club of Houston	
Society of St Vincent de Paul-Archdiocese of Galveston- Houston  2403 Holcombe	Blvd
Somerset	Ln
Sommermeyer	St
Songwood	St
Sonneville	Dr
Sorsby	Dr
Sorters	Rd
Sorters McLellan	Rd
South	Blvd
South	Dr
South	Fwy
South	Ln
South	Loop
South	St
South Acres Ranch Ltd  11409 Scott	St
South Gessner Child Care  10704 S Gessner	Dr
South Park Baptist Church  5830 Van Fleet	St
South Plant	
South Post Oak Baptist Church	
South Sam Houston	Pkwy
Southbank	
Southbelt Industrial	Dr
Southcrest	St
Southerland	Rd
Southfield	
Southford	St
Southgate	Blvd
Southlake	Dr
Southlea	St
Southmeadow	Dr
Southmore	
Southmore	Blvd
Southpoint	Ln
Southseas	St
Southwest	Fwy
Southwest High School  6400 Southwest	Fwy
Southwind	St
Sowden	Rd
Space Center	Blvd
Space Center blvd Bike	path
Space Center Houston  1601 Nasa	Pkwy
Spaulding	St
Spell	St
Spellman	Ct
Spellman	Rd
Spence	St
Spencer	St
Spenwick	Dr
Spice	Ln
Sporting Clay	Loop
Spring Barker	Dr
Spring Branch	Dr
Spring Independent School District  Clark Intermediate School  1825 Rushworth	Dr
Spring Independent School District  Link Elementary School  2815 Ridge Hollow	Dr
Spring Lake	Dr
Spring Valley	Rd
Springrock	Ln
Spruce Forest	Dr
Spruce Manor	Ln
Spruce Pine	Dr
St	
St Andrew Baptist Church  7802 Belroit	St
St Andrew Early Childhood Center  1353 Witte	Rd
St Andrew Kim Korean Catholic Church  1706 Bingle	Rd
St Andrew Lutheran Church  1353 Witte	Rd
St Andrew's Episcopal Church  1819 Heights	Blvd
St Andrews	Rd
St Augustine	
St Augustine	St
St Benedict	St
St Catherine of Siena Catholic  10688 Shadow Wood	Dr
St Catherine's Montessori  9821 Timberside	
St Charles	
St Charles	St
St Clair	St
St Edwards	Dr
St Edwards Green	Dr
St Elmo	St
St Emanuel	St
St Emanuel Baptist Church  4003 Elysian	St
St Francis De Sales Church  8200 Roos	Rd
St James	Pl
St James School	
St James School  3129 Southmore	
St John's Middle School  2401 Claremont	Ln
St Joseph	Pkwy
St Joseph	St
St Joseph Cemetery	
St Joseph Internal Medicine  1315 St Joseph	Pkwy
St Joseph Medical Center  1401 St Joesph	Pkwy
St Joseph Medical Center  1401 St Joseph	Pkwy
St Joseph Medical Center  1601 St Joseph	Pkwy
St Joseph Orthodox Christian  10644 Hammerly	Blvd
St Joseph Orthodox Christian Church  10644 Hammerly	Blvd
St Josephs Catholic Church  1505 Kane	St
St Lawrence	Dr
St Lo	Rd
St Louis	St
St Luke's Community Emergency Center-San Felipe  6363 San Felipe	St
St Michael Catholic Church  1801 Sage	Rd
St Michael Catholic School  1833 Sage	Rd
St Michael's Learning Academy  6420 Richmond	Ave
St Michaels Emergency Rooms  9000 Westheimer	
St Michaels Learning Academy  6420 Richmond	Ave
St Nicholas School  10420 Mullins	
St Peter Claver Catholic Church	
St Peter Claver Catholic Church  6005 N Wayside	Dr
St Peter School	
St Peter the Apostle Catholic  6220 La Salette	St
St Peter United Church-Christ  9022 Long Point	Rd
St Peter's EMS Inc  9800 Centre	Pkwy
St Peter's Syriac Orthodox Church  306 Magnolia Grove	Ln
St Peters Lutheran Church  1501 Houston	Ave
St William	Ln
Stabler	Ln
Stadium	Dr
Staffordshire	
Stallings	Dr
Stancliff	Rd
Stancliff	St
Stanford	Ct
Stanford	St
Stanwick	Dr
Staples	St
Star Houston Heliport	
State	Highway
State	Spur
State District Office of Tx  1350 Nasa	Pkwy
State Highway 36	Bypass
State Highway 8 Beltway Frontage	Rd
Stedman	St
Stella Link	Rd
Stepping Stones Charter Elementary School  11250 S Wilcrest	Dr
Sterling	St
Sterlingshire	St
Stetson	Ln
Stiles	St
Stillwood	Dr
Stone	St
Stone Brook	Ln
Stone Castle	Dr
Stone Center of St Joseph  1919 La Branch	St
Stone E	Dr
Stone Landing	Ln
Stone Mesa	Dr
Stone Pine	Ln
Stone Porch	Ln
Stone W	Dr
Stonebridge Creek	Ln
Stoneham	Ave
Stoney Brook	Dr
Stoneygrove	Loop
STP/5400 Westheimer Heliport	
Stratford	St
Strickland	St
Stuart	
Stuart	St
Stubner Airline Park  Veterans Memorial	Dr
Studemont	St
Studewood	St
Studewood Church of Christ  301 E 31st	St
Stuebner Airline	Rd
Styers	St
Suddley Castle	St
Sue	St
Sue Barnett	Dr
Sue Hamilton Ministries  9707 Springview	Ln
Suez	St
Sugar Branch	Dr
Sugar Land Baptist Church  16755 Southwest	Fwy
Sugarberry	Cir
Sul Ross	St
Sulphur	St
Summer	Run
Summer	St
Summer Harvest	Dr
Summer Heath	Ct
Summer Meadows	Ct
Summer Mill	Dr
Summer Rain	Dr
Summer Run	Dr
Summerbell	Ln
Summerbrook	Ct
Summerbrook	Dr
Summerhill	Dr
Summit Lake	Dr
Summit Ridge	Dr
Sumpter	Alley
Sumpter	St
Sun Harbor	Dr
Sun Prairie	Dr
Sunbeam	St
Sunbeam Baptist Church  7210 Shotwell	St
Sunbeam River	Dr
Sunbury	St
Sundown	Dr
Sunflower	St
Sunflower Bluff	Ln
Sunflower Chase	
Sunflower Prairie	Ct
Sunforest	Dr
Sunland Gardens	Ln
Sunny Heath	Ln
Sunnyland	St
Sunnyside	St
Sunnyside  3511 Reed	Rd
Sunnywood	Dr
Sunset	Blvd
Super	St
Swallow	
Swallow	St
Swallow Park	St
Sweet Grass	Trail
Sweetwater	Ln
Swonke	Ln
Sword to Sword  4141 Directors	Row
Sycamore	
Sycamore	Cir
Sycamore	Ln
Sycamore	St
Sycamore Creek	Dr
Sycamore Ridge	Ln
Sycamore Springs	Dr
Sycamore Villas	Dr
Sylvester	Rd
Sylvester Turner Park  2800 W Little York	Rd
Synott	Rd
T C Jester	Blvd
T C Jester	Park
T H  Rogers School	
T H McDonald Jr High School	
T H Rogers School  5840 San Felipe	St
Tabor	St
Tackaberry	St
Taft	
Taft	Ave
Taft	St
Talina	Way
Tall Pine	Dr
Talley	Ln
Tampico	St
Tanager	Ln
Tanager	St
Tangiers	Rd
Tanglewilde	Ave
Tanglewilde	Park
Tanglewilde	St
Tanner	Rd
Tareyton	Ln
Tarna	Ln
Tarnef	Dr
Tarver	St
Tate	
Taub Loop  Ben Taub General Hospital	
Tautenhahn	
Taylor	St
Tc Jester	Blvd
TCPA-Corinthian Pointe  5505	
Teague	Rd
Teal	St
Telean	St
Telegracia Studios of Houston  6203 Drayton Hall	
Telephone	Rd
Temple Bell	Dr
Temple Emanuel Church	
Tennessee	St
Terminal	Rd
Terminal A  2800 N Terminal	Rd
Terminal A  3500 N Terminal	Rd
Terrace Park	Dr
Terrell	St
Terry	St
Texarkana	St
Texas	
Texas	Ave
Texas	Pkwy
Texas	St
Texas 494	Loop
Texas 527	Spur
Texas 8 Beltway	
Texas 8 Beltway Frontage	Rd
Texas Acorn	Ave
Texas Annual Conference United  5215 Main	St
Texas Children's Pedtric Associates  705 S Fry	Rd
Texas Commerce Bank Bldg Heliport	
Texas School of Business-East  12030 East	Fwy
Texas School of Business-Southwest  6363 Richmond	Ave
Texas Southern University  3100 Cleburne	St
th	St
The Academy of Health Care Professions  8313 SW	Fwy
The Art Institute of Houston  4140 Southwest	Fwy
The Bear Boulevard School  8860 Westview	Dr
The Capital Grille  5365 Westheimer	Rd
The Crossing at White Oak  2424 E T C Jester	Blvd
The Health Museum  1515 Hermann	Dr
The Houston Dynamo Soccer Stadium	
The Houston Korean School  1809 Hollister	St
The Houston Museum of Natural Science  5555 Hermann Park	Dr
The Lancaster Houston  701 Texas	Ave
The Little Gym  8415 Stella Link	
The Rice School  7550 Seuss	Dr
The Texas Annual Conference  5215 Main	St
The University of Texas M  D  Anderson Cancer Center  1515 Holcombe	Blvd
The Westin Oaks Houston  5011 Westheimer	
The Westview School  1900 Kersten	Dr
Theodore Roosevelt Elementary School  6700 Fulton	St
Theron	St
Theta	St
Third Ward Church of Christ  2721 McIlhenny	St
Thomas	St
Thompson Elementary School  220 Casa Grande	Dr
Thorn Berry	Ln
Thornton	Rd
Thrasher	St
Tidewater	Dr
Tidewater	Ln
Tidford	St
Tidwell	Ln
Tidwell	Rd
Tidwell Fountains	Ln
Tidwell School	
Tierra Palms	Ct
Tierwester	St
Tierwester Village	St
Tiffany	Dr
Tiffin	St
Tiger	Trail
Tilgham	St
Tilson	Ln
Timber	Hollow
Timber	Ln
Timber Forest	Dr
Timber Oaks	Ln
Timber Strand	Dr
Timbergrove Baptist Church  946 W 17th	St
Timberline	Ct
Timberline	Dr
Timberline	Rd
Timberline Run	Ln
Timberoak	Dr
Timbers Trail	Dr
Timberwood	Dr
Tom McKinney Vocal Studios  8923 Autauga	
Tomball	Pkwy
Tooke	St
Topping	
Touchstone	St
Tower	St
Town Green	Dr
Town Lake	Ct
Town Park	Dr
Town Plaza	Dr
TownePlace Suites Houston i-10 West/Energy Corridor  15155 Katy	Fwy
Townwood	Dr
Townwood	Park
Tracewood	Bend
Tracewood	Cove
Tracewood	Ln
Tracewood Park	Dr
Trail Lake	Dr
Trail River	Dr
Trail Tree	Ln
Trailmont	Dr
Travis	
Travis	Ct
Travis	St
Travis Ct	Pl
Travis Elementary  3311 Beauchamp	St
Travis Point	Ln
Travis School  3311 Beauchamp	St
Tree	Ln
Trinity	
Trinity Evangelical Free Church	
Triola	Ln
Tristar	Dr
Triway	Ln
Tronewood	St
Troy	Rd
Troy	St
Trulley	St
TSU s Health And Physical Education Arena  3100 Cleburne	St
Tuam	St
Tuffly	St
Tulane	St
Tullis	Trail
Tullis Trail	Ct
Tully	Rd
Turnberry	Cir
Turnberry	Dr
Turnberry	Ln
Turnberry Park	Ln
Turner	
Turner	Dr
Turner	St
Turner Elementary School	
Turner Elementary School  3200 Rosedale	St
Turner Oaks	
Turner Place	Rd
Turner Point	Cir
Turquoise	Ln
Tuskegee	St
Twickenham	Trail
Twin Falls	Rd
Twin Oaks	St
Tybor	Dr
Tysa Cy Fair Club  12779 Jones	Rd
U	
U S  290 Business	
U S  290 Frontage	
U S  290 Frontage	Rd
U S  90 Alt	
U S  90 Business	
UH Health	Center
UH Police Dept	
Union	St
Union Mill	Rd
United	Dr
Unity	Dr
Unity  2929 Unity	Dr
Unity Church of Christianity  2929 Unity	Dr
University	Blvd
University Hills	Blvd
University of Houston  2440 Texas	Pkwy
University of Houston  4800 Calhoun	Rd
University Of Houston Bookstore  4800 Calhoun	Rd
University of Houston Cullen College of Engineering	
University of Houston Downtown-Commerce Street Bldg  320 N Main	St
University of Houston Fort Bend County Small Business Development Center  2440 Texas	Pkwy
University of Houston System  4242 S Mason	Rd
University of Houston System  4800 Calhoun	Rd
University of Houston-Clear Lake  2700 Bay Area	Blvd
University of Houston-Clear Lake  2700 E Bay Area	Blvd
University of Phoenix  4888 Loop Central	Dr
University of Phoenix-Clear Lake Learning Center  16055 Space Center	Blvd
University of Phoenix-Houston Northwest Learning Center  7900 North Sam Houston	Pkwy
University of St Thomas  3800 Montrose	Blvd
University of Texas Health Science Center at Houston  23920 Katy	Fwy
University of Texas-Recreation Center  7779 Knight	Rd
University of Tx Houston Core  11611 W Little York	Rd
University-Tx Diagnostic  6431 Fannin	St
University-Tx Medical  6431 Fannin	St
Upland	
Upland	Dr
Upland	Lakes
Upland Elm	St
Upland Lakes	Dr
Upland Rapids	Dr
Upland Willow	Ave
Upton	St
Upward Bound Private School  1319 W Mt Houston	Rd
Urban Fiesta Weekend  2616 S	Loop
Us	Highway
US Courthouse  515 Rusk	St
US District Court  515 Rusk	St
US Govt Dept of Commerce  15600 John F Kennedy	Blvd
US Post Office	
USA Karate  11101 Resource	Pkwy
Usener	St
Uvalde	Rd
Valencia	Dr
Valentine	St
Valentine	Way
Valley Lake	Dr
Valley Park	Dr
Valley View	Ln
Valley W	Ct
Van Fleet	St
Van Ness	St
Van Wall	St
Vandalia	Way
Vasser	Rd
Vaulted Oak	St
Vena	Dr
Venus	St
Venus Park	Ln
Vera Lou	St
Verdome	Ln
Vermont	St
Veterans Memorial	Dr
Vickery	Dr
Vickery	Rd
Vickery	St
Victoria	Dr
Victoria	St
Victoria	Way
Victory	
Victory	Dr
Victory	St
Victory Christian Center  11420 Cutten	Rd
Victory Church of God in Christ  4609 Engleford	St
Victory In Jesus Evangelistic  4740 W Orem	Dr
Victory Inner City Ministries  18 1/2 Veenstra	St
Victory Temple  14203 Wallisville	Rd
Victory Temple Church of God  9402 Dodson	St
Villa	St
Villa Lea	Ln
Villa Lee	Ln
Village	Way
Village Corner	Dr
Village Dale	Ave
Village Evergreen	Trail
Village Middle School  13077 Westella	Dr
Village Rose	Ln
Vincent	St
Vinett	St
Vinita	St
Vintage	St
Vintage Park	Blvd
Virgil	St
Virginia	Ave
Virginia	St
Virginia Colony	Dr
Vista Brook	Dr
Vista Del Mar	Dr
Vista Del Rancho	Dr
Vistaglen	Loop
Vogel	Rd
Vogue	Ln
Voss	Rd
W Bellfort	Ave
Waco	St
Wakefield	Dr
Waldo	St
Walker	
Walker	St
Walker-McKinney	
Wall	St
Waller	St
Wallingford	Dr
Wallingford	Pines
Wallingford	Pl
Wallisville	Rd
Walnut	
Walnut	Ln
Walnut	Rd
Walnut	St
Walnut Bend	Ln
Walnut Bend School  10620 Briar Forest	Dr
Walnut Creek	Dr
Walton	St
Walton Heath	Dr
Waltrip	St
Waltrip High School  1900 W 34th	St
Waltrip High School Baseball	Field
War Memorial	Dr
Ward	St
Warner	Rd
Warner	St
Washington	
Washington	Ave
Washington	Dr
Washington	Rd
Washington	St
Waterloo	Dr
Watkin	Way
Watonga	Blvd
Watson	
Waugh	Dr
Waugh Bridge Bats	
Waughcrest	Dr
Wavell	St
Waxahachie	St
Way	St
Wayforest	Dr
Wayne	St
Waynesboro	Dr
Wayside	
Wayside	Dr
Wayside Stream	Ln
Weaver	Rd
Weaver	St
Weaver A Odom Elementary School  14701 Henry	Rd
Weber	St
Webster	
Webster	St
Webster Ranch	Rd
Weedy	Ln
Weems	St
Weeping Willow	Rd
Weiss	St
Welch	St
Welch Middle School  11544 S Gessner	Rd
Wellington	St
Wells Fargo	Dr
Wenda	St
Wendemere	St
Wentworth	Ct
Wentworth	St
Wentworth Park	Dr
Werner	St
Weslayan	St
Wesley	St
West End Church of Christ  718 Malone	St
West Grand	Pkwy
West Houston Airport (IWS)  18000 Groeschke	Rd
West Houston Medical Center Heliport	
West I-10 Fire Dept  20011 Westfield	Pkwy
West I-10 Fire Dept  22855 Franz	Rd
West Orem Early Childhood Center  3711 W Orem	Dr
West Orem Missionary Baptist Church	
West Orem Recreation Center  3419 W Orem	Dr
West Sam Houston	Pkwy
West University City Office  3814 University	Blvd
West University Place Police  3814 University	Blvd
West Webster Street	Park
Westbrae	Pkwy
Westbranch	Dr
Westcenter	Dr
Westcott	Rd
Westcott	St
Westcreek	Ln
Westcrest	Dr
Westella	Dr
Westerland	Dr
Western Village	Ln
Westfield	St
Westford	St
Westgate	St
Westgreen	Blvd
Westhampton	Dr
Westheimer	
Westheimer	Ct
Westheimer	Pkwy
Westheimer	Rd
Westheimer	Way
Westheimer Air	Park
Westheimer Community Church	
Westheimer Pl	Dr
Westholme	Dr
Westin Oaks Houston  5011 Westheimer At Post Oak	
Westlake	Rd
Westmart	Dr
Weston	St
Westover	St
Westpark	Dr
Westpark Learning Center  3969 S Gessner	Rd
Westpark Tollway	
Westport	Ln
Westridge	
Westridge	St
Westview	Dr
Westview Baptist Church  6711 Long Point	Rd
Westview Cir	Dr
Westward	
Westward	St
Westway	
Westway	Dr
Westway	Ln
Westway	St
Weyburn	St
Wheatley	
Wheatley	St
Wheeler	
Wheeler	St
Wheeler Avenue Baptist Church  3826 Wheeler	Ave
Whispering Creek	Way
Whispering Pines	Ave
White Blossom	Ln
White Clover	Dr
White Heather	Dr
White Oak	
White Oak	Cir
White Oak	Ct
White Oak	Dr
White Oak	Ln
White Oak	Pl
White Oak Bend	Dr
White Oak Landing	Blvd
White Oak Trail	Ln
White Oaks Hills	Ln
Whitecastle	Ln
Whitestone	Ln
Whitney	St
Whitney	Way
Whittington	Dr
Wickbriar	Dr
Wickchester	Ln
Wicker	Way
Wicker Forest	Ln
Wickersham	
Wickersham	Ln
Wier	Dr
Wiggins	St
Wilburforce	St
Wilcrest	Dr
Wilcrest Baptist Church  10800 Sharpview	Dr
Wilcrest Field Services Inc  8535 Jackrabbit	Rd
Wilcrest Green	Dr
Wild Basin	Dr
Wild Mustang	Ln
Wildwood Ridge	Ct
Wildwood Ridge	Dr
Wiley	Rd
Wiley	St
Wileyvale	Rd
Wileywood	Dr
Will Anderson	Rd
Will Clayton	Pkwy
Willard	St
Willia	St
William P  Hobby Airport (HOU)  7800 Airport	Blvd
William P  Hobby Airport (HOU)  8183 Airport	Blvd
Williams	St
Willomine	Way
Willow	Cir
Willow	Dr
Willow	St
Willow	Trail
Willow Centre	Dr
Willow Chase	Blvd
Willow Chase	Dr
Willow Creek	Way
Willow Glen	Dr
Willow Moss	Dr
Willow Pl	Dr
Willow Pond	Pl
Willow Terrace	Dr
Willow W	Dr
Willowbend	Blvd
Willowick	Rd
Willows	Rd
Wilmington	
Wilmington	St
Wiloak	St
Wilshire	Ct
Wilshire	St
Wilshire Pl	Dr
Wilson Air Center  9000 Randolph	St
Wilton	St
Wimberly	St
Wimberly Canyon	Ct
Windemere	St
Windfern	Dr
Windfern	Rd
Windfern Forest	Dr
Windfern High School	
Windfern Lakes	St
Windfern Trace	Dr
Winds	Dr
Windsor	
Windsor	Ct
Windsor	Dr
Windsor	Manor
Windsor	Pl
Windsor	St
Windsor Forest	Dr
Windsor Village Elementary School  14440 Polo	St
Windsor Village United Methodist Church  6000 Heatherbrook	Dr
Windsor Woods	Ln
Windswept	
Windswept	Dr
Windswept	Ln
Windswept Grove	Dr
Windy Heath	Ln
Wingfoot	Rd
Winkler	Dr
Winrock	Blvd
Winston	St
Winston Homestead	St
Winton	
Winton	St
Wipprecht	St
Wirt	Rd
Wisterwood	Dr
Witcher	Ln
Witte	Rd
Wolbrook	St
Wood	St
Wood Bayou	Dr
Wood Bluff	Blvd
Wood Canyon	Dr
Wood Forest	Blvd
Wood Forest	Dr
Wood Grove	Ct
Wood Orchard	Ct
Wood Orchard	Dr
Wood River	Dr
Woodard	St
Woodbine	St
Woodchase	Dr
Woodcreek	Ln
Woodcreek Middle School  14600 Woodson Park	Dr
Woodcrest	Dr
Wooded Pine	Dr
Woodfair	Dr
Woodfern	Dr
Woodforest	Blvd
Woodforest	Ct
Woodforest	Dr
Woodforest Chase Community Center  12475 Wood Forest	Dr
Woodforest Presbyterian Church  15330 Wallisville	Rd
Woodhead	St
Woodhollow	Ln
Woodland	Park
Woodland Gardens	Dr
Woodland Grove	Dr
Woodland Hills	Dr
Woodland Oaks	Dr
Woodland Park	Dr
Woodlark	St
Woodlyn	Rd
Woodridge	Dr
Woodridge	Pl
Woodridge Baptist Church of Kingwood  5707 Kingwood	Dr
Woodridge Cove	Dr
Woodridge Manor	Dr
Woodridge Row	Dr
Woodridge Square	Dr
Woodrow	St
Woodruff	St
Woods	Ln
Woods Estates	Dr
Woodshire	St
Woodsman	Trail
Woodson Park	Dr
Woodvine	Dr
Woodway	Dr
Woodwind	Dr
Woolworth	St
Worms	St
Wrenthorpe	Dr
Wright	Blvd
Wright	Rd
Wright Oaks	Dr
Wrightwood	St
Wrigley	St
Wroxton	Rd
Wuthering Heights	Dr
Wyandott	Blvd
Wycliffe	Dr
Wylie	St
Wynne	St
Wynona	St
Yale	
Yale	Ct
Yale	St
Yale Street Baptist Church	
Yale Street Tabernacle Church of God in Christ	
Yearling Colt	Ct
Yellowstone	Blvd
Yellowstone	Park
Yellowstone Academy  3000 Trulley	St
Yellowstone Boulevard  5154 Idaho	St
Yellowstone Boulevard Missionary Baptist Church	
Yellowstone Way	Dr
Yoakum	
Yoakum	Blvd
Yoe	St
York	
York	St
Yorkshire	
Yorktown	
Yorktown	Dr
Yorktown	St
Yorktown Colony	Dr
Yorktown Crossing	Pkwy
Yorktown Meadow	Ln
Yorktown Plaza	Dr
Younglake Boulevard  Kindercare  19823 Younglake	Blvd
Yuma	St
Zavalla	St
Zelma	Dr
Zephyr	St
Ziggy's Bar and Grill Montrose  302 Fairview	
Ziggy's Bar and Grill River Oaks  2202 W Alabama	
Zoe	St
