BarringtonHills - Barrington Hills
BuffaloGrove - Buffalo Grove
ClarendonHills - Clarendon Hills
CrystalLake - Crystal Lake
DesPlaines - Des Plaines
ForestPark - Forest Park
FoxRiverGrove - Fox River Grove
GlenEllyn - Glen Ellyn
GraysLake - Grayslake
HoffmanEstates - Hoffman Estates
HomerGlen - Homer Glen
LaGrange - La Grange
LaGrangePark - La Grange Park
LakeBluff - Lake Bluff
LakeForest - Lake Forest
LakeInTheHills - Lake in the Hills
LakeZurich - Lake Zurich
MortonGrove - Morton Grove
MountProspect - Mount Prospect
NewLenox - New Lenox
OakBrook - Oak Brook
OakPark - Oak Park
OrlandHills - Orland Hills
PalosHeights - Palos Heights
PalosHills - Palos Hills
PalosPark - Palos Park
ParkRidge - Park Ridge
ProspectHeights - Prospect Heights
RiverForest - River Forest
RollingMeadows - Rolling Meadows
RoundLake - Round Lake
VernonHills - Vernon Hills
VillaPark - Villa Park
WestChicago - West Chicago
WesternSprings - Western Springs
arlingtonheights - Arlington Heights
downersgrove - Downers Grove
glenview - Glenview
highlandpark - Highland Park
hinsdale - Hinsdale
naperville - Naperville
orlandpark - Orland Park
stcharles - St. Charles
tinleypark - Tinley Park
wheaton - Wheaton
wilmette - Wilmette
AlexandriaKY - Alexandria
AmberlyVillage - Amberly Village
AndersonTownship - Anderson Township
BataviaTownship - Batavia Township
BellevueKY - Bellevue
BlueAsh - Blue Ash
Burlingtonky - Burlington
ColdSpringKY - Cold Spring
ColerainTownship - Colerain Township
CovingtonKY - Covington
Deerfieldtownship - Deerfield Township
DehliTownship - Delhi Township
EdgewoodKY - Edgewood
ElsmereKY - Elsmere
ErlangerKY - Erlanger
Florenceky - Florence
FortMitchellKY - Fort Mitchell
FortThomasKY - Fort Thomas
GoshenTownship - Goshen Township
Hebronky - Hebron
HighlandHeightsKY - Highland Heights
HydePark - Hyde Park
IndependenceKY - Independence
IndianHill - Indian Hill
MiamiTownship - Miami Township
MiamiTownship(Clermont) - Miami Township
MountLookout - Mount Lookout
MountWashington - Mount Washington
Mtadams - Mount Adams
NewportKY - Newport
PierceTownship - Pierce Township
SouthgateKY - Southgate
SpringfieldTownship - Springfield Township
SycamoreTownship - Sycamore Township
SymmesTownship - Symmes Township
TerracePark - Terrace Park
UnionTownship - Union Township
Unionky - Union
VillaHillsKY - Villa Hills
Waltonky - Walton
WilderKY - Wilder
ClearLake - Clear Lake
FortBend - Fort Bend
GardenOaks - Garden Oaks
LaMarque - La Marque
LeagueCity - League City
MissouriCity - Missouri City
OakRidgeNorth - Oak Ridge North
RiverOaks - River Oaks
SpringBranch - Spring Branch
SugarLand - Sugar Land
TexasCity - Texas City
TheWoodlands - The Woodlands
WestUniversity - West University Place
alvin - Alvin
atascocita - Atascocita
bellaire - Bellaire
cincoranch - Cinco Ranch
IsleofWightCounty - Isle of Wight County
JamesCityCounty - James City County
NewportNews - Newport News
YorkCounty - York County
yorktown - Yorktown
collegepark - College Park
winter - Winter Park
CoconutCreek - Coconut Creek
CoopCity - Cooper City
LighthousePoint - Lighthouse Point
NoLauderdale - North Lauderdale
PemPines - Pembroke Pines
PompanoBeach - Pompano Beach
coralsprings - Coral Springs
fortlauderdale - Fort Lauderdale
lakew - Lake Worth
oaklandpark - Oakland Park
royal - Royal Palm Beach
southeastbroward - Southeast Broward
sunrise - Sunrise
weston - Weston
